CTGGGGTAGTTCCAATGCG: TGGGGTAGTTCCAATGCGA
CTTTGATTGGAACGTCTTT: TTTGATTGGAACGTCTTTT
AGCCTCGGTTTCCAGCCGC: GCCTCGGTTTCCAGCCGCA
CCGGGAGAGGTGCCGTATG: CGGGAGAGGTGCCGTATGG
TAAAAACGTGCTAGGGAGG: AAAAACGTGCTAGGGAGGT
GTTCATATTCAGGGACACT: TTCATATTCAGGGACACTG
GAAAAGTTGAAGCACGTGT: AAAAGTTGAAGCACGTGTT
ACCCTTAGGGCTGGGCTGA: CCCTTAGGGCTGGGCTGAA
AAAGGCGATGCGCTATACC: AAGGCGATGCGCTATACCA
GCCATGTCCAGTGTCAACT: CCATGTCCAGTGTCAACTG
GACAGGCCTATAAAGCCAC: ACAGGCCTATAAAGCCACC
CCCTCGCAGGCTGGGCAAC: CCTCGCAGGCTGGGCAACA
AGAAGCTTAACGCGTTCCC: GAAGCTTAACGCGTTCCCG
TAAGTTGTCGCTTGCCTGT: AAGTTGTCGCTTGCCTGTC
CATATTCAGGGACACTGGG: ATATTCAGGGACACTGGGG
AAATTTCGGTTGCCTGACT: AATTTCGGTTGCCTGACTG
TTAGCAACATTTAACAAGC: TAGCAACATTTAACAAGCA
ACAACTGTGAGTTGAACGT: CAACTGTGAGTTGAACGTC
ATGTTGCTTGTGTCCGGGA: TGTTGCTTGTGTCCGGGAG
CTGACTGTCGTCCCCTAAA: TGACTGTCGTCCCCTAAAC
TGCGAAGCAATCCAAGCAG: GCGAAGCAATCCAAGCAGT
CAACGCACATTCCTAGGGG: AACGCACATTCCTAGGGGT
TGTTGATGCACGAGGGCTT: GTTGATGCACGAGGGCTTG
TACAATAGCGAGAGTAAGA: ACAATAGCGAGAGTAAGAG
AATATGTGGCGATAAGGAG: ATATGTGGCGATAAGGAGA
CGACATAATGTGTTTAACG: GACATAATGTGTTTAACGA
GCCGTCTTGCACTTATACG: CCGTCTTGCACTTATACGT
ATAGCTAGGTTTCAGTGGT: TAGCTAGGTTTCAGTGGTG
CTTAGGGCTGGGCTGAAGA: TTAGGGCTGGGCTGAAGAA
CTAACCCTAAAACCAATCA: TAACCCTAAAACCAATCAA
TTGGTAGGAATGCCAAGCC: TGGTAGGAATGCCAAGCCC
TGTATTGCCTCCTTTAAGT: GTATTGCCTCCTTTAAGTG
CGAGCACGACGGTGAACCT: GAGCACGACGGTGAACCTG
GTGGCTTCTGATCGAGTGC: TGGCTTCTGATCGAGTGCG
CCCTTAGGGCTGGGCTGAA: CCTTAGGGCTGGGCTGAAG
GAATCCCTCGATCCAGGCA: AATCCCTCGATCCAGGCAG
TCCCTCGATCCAGGCAGTC: CCCTCGATCCAGGCAGTCA
AAACACAGAGATCACTACA: AACACAGAGATCACTACAT
GAATGTCACCTTGTTCAAT: AATGTCACCTTGTTCAATG
TTCATGAGTTCGATTACAA: TCATGAGTTCGATTACAAC
TTTGATTTCCCGAATCTGC: TTGATTTCCCGAATCTGCC
GCAATCCAAGCAGTCTGCC: CAATCCAAGCAGTCTGCCG
GTAGTTCCAATGAGGGCCC: TAGTTCCAATGAGGGCCCC
TATTCAGGGACACTGGGGT: ATTCAGGGACACTGGGGTA
ACGTGGATTGCGAAGTGGC: CGTGGATTGCGAAGTGGCA
GACCGAGATTCCGGGTCAT: ACCGAGATTCCGGGTCATG
CATAGGTTTAAATCTTGCT: ATAGGTTTAAATCTTGCTT
CAAGTTCTCTTAAATAAGT: AAGTTCTCTTAAATAAGTT
ATAAAGCCACCCAGCTGCG: TAAAGCCACCCAGCTGCGT
ATTAGTCCTCGTCGGGTTA: TTAGTCCTCGTCGGGTTAC
CTCAGTACCGGAATAGAAG: TCAGTACCGGAATAGAAGC
ATTCTGTCCTAGCGGAGCT: TTCTGTCCTAGCGGAGCTC
TTTGCAATGAAGATGGGGA: TTGCAATGAAGATGGGGAT
TTATACGTGGATTGCGAAG: TATACGTGGATTGCGAAGT
TGACTAACTAATCGAAAAA: GACTAACTAATCGAAAAAC
CATCGAATTAGTCCTCGTC: ATCGAATTAGTCCTCGTCG
CAATATGTGGCGATAAGGA: AATATGTGGCGATAAGGAG
TTCTGATCGAGTGCGATCA: TCTGATCGAGTGCGATCAC
CAAGCATCTCGTGGCCCAG: AAGCATCTCGTGGCCCAGG
AATCCTATTCCTAAATGCC: ATCCTATTCCTAAATGCCA
ACCATATCTAGACTAAGGG: CCATATCTAGACTAAGGGC
CTGGGGTAGTTCCAATGAG: TGGGGTAGTTCCAATGAGG
GACTCGAATAGCCTGAATC: ACTCGAATAGCCTGAATCC
ACTGTCGCATGGGGCCGCC: CTGTCGCATGGGGCCGCCT
TTTTGTATCAGTGTCACAG: TTTGTATCAGTGTCACAGA
GTTCCAATGCGAGGGTCTT: TTCCAATGCGAGGGTCTTC
ATCAGTGTCACAGACCACC: TCAGTGTCACAGACCACCA
GTAGTTCCAATGTTCCCGA: TAGTTCCAATGTTCCCGAT
GGCTGGCCCAAAACCCAGA: GCTGGCCCAAAACCCAGAC
ACTAAGGGCATGTAACCTT: CTAAGGGCATGTAACCTTT
ATCACGTCCACGTTCGGTT: TCACGTCCACGTTCGGTTC
GTGAATACAGTAGGAAATT: TGAATACAGTAGGAAATTT
CCCACCCTTAGGGCTGGGC: CCACCCTTAGGGCTGGGCT
CCATATCTAGACTAAGGGC: CATATCTAGACTAAGGGCA
GATGCGCTATACCATCGTT: ATGCGCTATACCATCGTTC
GGTCATGAAGATTTCCTTC: GTCATGAAGATTTCCTTCT
CCGCTTGGTAGGAATGCCA: CGCTTGGTAGGAATGCCAA
GCTACTCCTGTTTGTATTG: CTACTCCTGTTTGTATTGC
TCCGGGTCATGCTGTTTTA: CCGGGTCATGCTGTTTTAA
CCTGTTTGTATTGCCTCCT: CTGTTTGTATTGCCTCCTT
CCAATGAGGGCCCCGCACC: CAATGAGGGCCCCGCACCT
GGGACACTGGGGTAGTTCC: GGACACTGGGGTAGTTCCA
CATGGACAGGCCTATAAAG: ATGGACAGGCCTATAAAGC
CCTTCCCCGAGGAATTTGG: CTTCCCCGAGGAATTTGGT
GGATCGTGTTGTTAAAACC: GATCGTGTTGTTAAAACCT
TTCATGGACAGGCCTATAA: TCATGGACAGGCCTATAAA
TCCTTCGGAATTCAACTTT: CCTTCGGAATTCAACTTTA
CCTTGTCCATTCATATAGC: CTTGTCCATTCATATAGCT
GTGGCTCTTGTGAATACAG: TGGCTCTTGTGAATACAGT
GACAGAGGCTGACGGATTC: ACAGAGGCTGACGGATTCG
TGACCGAGATTCCGGGTCA: GACCGAGATTCCGGGTCAT
ACCTGTCATATGGTACTGG: CCTGTCATATGGTACTGGG
CCGCACCTCGCAGGCTGGG: CGCACCTCGCAGGCTGGGC
TACAAACCTCTATAGGTGG: ACAAACCTCTATAGGTGGC
GGAAGGCTACGCGTCGGGC: GAAGGCTACGCGTCGGGCT
ACGACGGTGAACCTGTCAT: CGACGGTGAACCTGTCATA
ATCTCGTGGCCCAGGTATC: TCTCGTGGCCCAGGTATCG
GGGTAGTTCCAATGTTCCC: GGTAGTTCCAATGTTCCCG
CTTGTTCAACCGCGTCATC: TTGTTCAACCGCGTCATCA
GCGATCACTGTTGTTATTT: CGATCACTGTTGTTATTTG
TGTTTTAACACGTGTTGTA: GTTTTAACACGTGTTGTAG
TGGGTCGAAAAACGATGAG: GGGTCGAAAAACGATGAGG
CGATTTCTAGCGAGCACGA: GATTTCTAGCGAGCACGAC
ACCTTTCGGCTAGACGGTT: CCTTTCGGCTAGACGGTTT
AAATAAGTTGTCGCTTGCC: AATAAGTTGTCGCTTGCCT
CGACGTCTTGCAAGGGCCC: GACGTCTTGCAAGGGCCCA
GTGCTAGGGAGGTAAAGGT: TGCTAGGGAGGTAAAGGTC
TGCCCACCCGGGCTGATCT: GCCCACCCGGGCTGATCTT
TTTAACGGATTCTGTCCTA: TTAACGGATTCTGTCCTAG
GGGCATAGGTTTAAATCTT: GGCATAGGTTTAAATCTTG
AGTCCTGAGGACACAGCCT: GTCCTGAGGACACAGCCTG
GAGAGGTGCCGTATGGTGA: AGAGGTGCCGTATGGTGAA
TGAACGTCTTACACCCAAG: GAACGTCTTACACCCAAGA
GGGCGCTTAGACTCGCTTG: GGCGCTTAGACTCGCTTGC
ACGGCTCAGTACCGGAATA: CGGCTCAGTACCGGAATAG
CGAGTGCGATCACTGTTGT: GAGTGCGATCACTGTTGTT
TGGGCAACATTTATCAGCT: GGGCAACATTTATCAGCTC
CAGTGTCACAGACCACCAA: AGTGTCACAGACCACCAAG
GGCTCAGTACCGGAATAGA: GCTCAGTACCGGAATAGAA
ACAAGCATCTCGTGGCCCA: CAAGCATCTCGTGGCCCAG
CTTACACTTCACTACAGTA: TTACACTTCACTACAGTAT
CTTGCGCCCAAAAGCTAGA: TTGCGCCCAAAAGCTAGAG
CCAAGCAGTCTGCCGTGGT: CAAGCAGTCTGCCGTGGTA
GTCCTAGCGGAGCTCAAAA: TCCTAGCGGAGCTCAAAAA
GCCTGAATCCAGACTGATT: CCTGAATCCAGACTGATTC
ACCATCGTTCACCTTGTCC: CCATCGTTCACCTTGTCCA
CCACCCTTAGGGCTGGGCT: CACCCTTAGGGCTGGGCTG
GCCTCCTCATTCGACATAA: CCTCCTCATTCGACATAAT
GGGGATTCGGCACCAACAT: GGGATTCGGCACCAACATT
TCGATTACAACGTCCCGCC: CGATTACAACGTCCCGCCG
CTATAAAGCCACCCAGCTG: TATAAAGCCACCCAGCTGC
TCTGATCGAGTGCGATCAC: CTGATCGAGTGCGATCACT
ATTCCGGGTCATGCTGTTT: TTCCGGGTCATGCTGTTTT
CGGTTTCCAGCCGCACAGC: GGTTTCCAGCCGCACAGCA
AAGCACGTGTTGCAGTCTA: AGCACGTGTTGCAGTCTAA
GTCTTGCACTTATACGTGG: TCTTGCACTTATACGTGGA
GCAACATTTATCAGCTCGC: CAACATTTATCAGCTCGCG
GGCAACACCCTCCGCCCAC: GCAACACCCTCCGCCCACA
TAGACTCGCTTGCATGCAA: AGACTCGCTTGCATGCAAC
AGCTTAACGCGTTCCCGAC: GCTTAACGCGTTCCCGACG
CCTCGCAGGCTGGGCAACA: CTCGCAGGCTGGGCAACAA CTCGCAGGCTGGGCAACAA CTCGCAGGCTGGGCAACAG CTCGCAGGCTGGGCAACAT
CGAAAAACGATGAGGGGCG: GAAAAACGATGAGGGGCGC
CCTTTCGGCTAGACGGTTT: CTTTCGGCTAGACGGTTTA
AGATCACTACATAGGCGTG: GATCACTACATAGGCGTGC
GCTCTTGTGAATACAGTAG: CTCTTGTGAATACAGTAGG
GCTCGTTTGCGGCATGTAA: CTCGTTTGCGGCATGTAAG
CACGTGTTGCAGTCTAACC: ACGTGTTGCAGTCTAACCC
AAGCTTAACGCGTTCCCGA: AGCTTAACGCGTTCCCGAC
GATTCGCGGTCATGAAGAT: ATTCGCGGTCATGAAGATT
GAGCGTTACGACGTGTTTG: AGCGTTACGACGTGTTTGC
GGTTTAAATCTTGCTTTCA: GTTTAAATCTTGCTTTCAT
TTACACTTCACTACAGTAT: TACACTTCACTACAGTATT
GTATGACTCGAGATGACAG: TATGACTCGAGATGACAGA
GTTCGGTTCGATGCCCACC: TTCGGTTCGATGCCCACCC
TCTTGTGAATACAGTAGGA: CTTGTGAATACAGTAGGAA
GCTACGCGTCGGGCTGGCC: CTACGCGTCGGGCTGGCCC
TGTCCAGTGTCAACTGGGG: GTCCAGTGTCAACTGGGGT
CTGGGCATAGGTTTAAATC: TGGGCATAGGTTTAAATCT
CGTCCACGTTCGGTTCGAT: GTCCACGTTCGGTTCGATG
GCCGGCAACACCCTCCGCC: CCGGCAACACCCTCCGCCC
TGCGCAGTTATCAATGGTG: GCGCAGTTATCAATGGTGG
AGGTCGAAAACATTGCTCA: GGTCGAAAACATTGCTCAC
AACCTTTCGGCTAGACGGT: ACCTTTCGGCTAGACGGTT
GACATAATGTGTTTAACGA: ACATAATGTGTTTAACGAT
GTACAAACCTCTATAGGTG: TACAAACCTCTATAGGTGG
CTCCGATCTCGCCGCGCTT: TCCGATCTCGCCGCGCTTT
ATGCCAAGCCCCACACCAT: TGCCAAGCCCCACACCATA
TAGGTGGCGAGACAACGCA: AGGTGGCGAGACAACGCAC
TGTAACAGTGCAATATGTG: GTAACAGTGCAATATGTGG
AAACCAATCAACATCGAAT: AACCAATCAACATCGAATT
TGTGAGTTGAACGTCTTAC: GTGAGTTGAACGTCTTACA
GTTCATGAGTTCGATTACA: TTCATGAGTTCGATTACAA
GTATTGCCTCCTTTAAGTG: TATTGCCTCCTTTAAGTGG
CTCATTCGACATAATGTGT: TCATTCGACATAATGTGTT
TCTGTCCTAGCGGAGCTCA: CTGTCCTAGCGGAGCTCAA
GGAGTTGGGTCGAAAAACG: GAGTTGGGTCGAAAAACGA
ATGAAAAGGCGATGCGCTA: TGAAAAGGCGATGCGCTAT
GGATTGCGAAGTGGCAACC: GATTGCGAAGTGGCAACCA
GCAAGGGCCCACCCTTAGG: CAAGGGCCCACCCTTAGGG
CGTCTTTTGTATCAGTGTC: GTCTTTTGTATCAGTGTCA
CATGTCCAGTGTCAACTGG: ATGTCCAGTGTCAACTGGG
GGGGCCGCCTCCCACCGAA: GGGCCGCCTCCCACCGAAT
GGAGAGGTGCCGTATGGTG: GAGAGGTGCCGTATGGTGA
AGAAGCAAAGCCTGATCTG: GAAGCAAAGCCTGATCTGA
CGCCGGCAACACCCTCCGC: GCCGGCAACACCCTCCGCC
CCTTTAAGTGGAAGGCTAC: CTTTAAGTGGAAGGCTACG
TCAAAAAGTCAGCCTCGGT: CAAAAAGTCAGCCTCGGTT
CGTTACGACGTGTTTGCAA: GTTACGACGTGTTTGCAAT
AACGCGTTCCCGACGGATG: ACGCGTTCCCGACGGATGC
AGGAAACACAGAGATCACT: GGAAACACAGAGATCACTA
GTGTATATTTTTGCGCAGT: TGTATATTTTTGCGCAGTT
ACTTGTTCAACCGCGTCAT: CTTGTTCAACCGCGTCATC
ACAGTTTCCTTCGGAATTC: CAGTTTCCTTCGGAATTCA
AACCCTTATCAGTACTGTC: ACCCTTATCAGTACTGTCG
AGCGAGAGTAAGAGGACTG: GCGAGAGTAAGAGGACTGG
GACCACCAAGGGAGTTGGG: ACCACCAAGGGAGTTGGGT
ACACAGAGATCACTACATA: CACAGAGATCACTACATAG
GTTTAAATCTTGCTTTCAT: TTTAAATCTTGCTTTCATG
ATGAGTTCGATTACAACGT: TGAGTTCGATTACAACGTC
TTATCAGTACTGTCGCATG: TATCAGTACTGTCGCATGG
TAGTTCCAATGAGGGCCCC: AGTTCCAATGAGGGCCCCG
AATGAAGATGGGGATCGTG: ATGAAGATGGGGATCGTGT
AAGCCTGATCTGATCACAC: AGCCTGATCTGATCACACA
TCCTAGGGGTGACTAACTA: CCTAGGGGTGACTAACTAA
GTCGTCCCCTAAACTAATG: TCGTCCCCTAAACTAATGT
ACATTCTGCGAAGCAATCC: CATTCTGCGAAGCAATCCA
CAACATTCTGCGAAGCAAT: AACATTCTGCGAAGCAATC
TGCGAAGTGGCAACCATAC: GCGAAGTGGCAACCATACT
ACGTTCGGTTCGATGCCCA: CGTTCGGTTCGATGCCCAC
CCAATGGAATAACATCGCC: CAATGGAATAACATCGCCT
ATGAAGATGGGGATCGTGT: TGAAGATGGGGATCGTGTT
CGTATGGTGAAACCCTTAT: GTATGGTGAAACCCTTATC
CTCGAGATGACAGAGGCTG: TCGAGATGACAGAGGCTGA
CATTTAACAAGCATCTCGT: ATTTAACAAGCATCTCGTG
CATGCAACCCAGACACTCC: ATGCAACCCAGACACTCCG
CGTGTTGCAGTCTAACCCT: GTGTTGCAGTCTAACCCTA
GCGAGCACGACGGTGAACC: CGAGCACGACGGTGAACCT
CTTTCATGGACAGGCCTAT: TTTCATGGACAGGCCTATA
GACGGTTTATCATTTCGAA: ACGGTTTATCATTTCGAAC
CCCAGACACTCCGATCTCG: CCAGACACTCCGATCTCGC
CACTTATACGTGGATTGCG: ACTTATACGTGGATTGCGA
ATCGTTCACCTTGTCCATT: TCGTTCACCTTGTCCATTC
CGGTTTATCATTTCGAACG: GGTTTATCATTTCGAACGA
CGCTTGGTAGGAATGCCAA: GCTTGGTAGGAATGCCAAG
CCTCCTCATTCGACATAAT: CTCCTCATTCGACATAATG
GCCAAGCCCCACACCATAT: CCAAGCCCCACACCATATC
TTGTAGGTCGAAAACATTG: TGTAGGTCGAAAACATTGC
CAACGTCCCGCCGTATGAC: AACGTCCCGCCGTATGACT
CGATGCGCTATACCATCGT: GATGCGCTATACCATCGTT
GTATATTTTTGCGCAGTTA: TATATTTTTGCGCAGTTAT
CAACAGTTTCCTTCGGAAT: AACAGTTTCCTTCGGAATT
TTTAACACGTGTTGTAGGT: TTAACACGTGTTGTAGGTC
CCAAGCCCCACACCATATC: CAAGCCCCACACCATATCT
GGTACAGAATTTAGCTACT: GTACAGAATTTAGCTACTC
GGTAGGAATGCCAAGCCCC: GTAGGAATGCCAAGCCCCA
ACGTGTTGCAGTCTAACCC: CGTGTTGCAGTCTAACCCT
ATGGTGAAACCCTTATCAG: TGGTGAAACCCTTATCAGT
AGCACGACGGTGAACCTGT: GCACGACGGTGAACCTGTC
GAATTTGGTTGACCGAGAT: AATTTGGTTGACCGAGATT
GTTCCAATGAGGGCCCCGC: TTCCAATGAGGGCCCCGCA
ATAGCGAGAGTAAGAGGAC: TAGCGAGAGTAAGAGGACT
GGCTGGGCAACAGTTTCCT: GCTGGGCAACAGTTTCCTT
TAGAGAGGGGGTAGTCCTG: AGAGAGGGGGTAGTCCTGA
CGATCACTGTTGTTATTTG: GATCACTGTTGTTATTTGC
TGAAAGTGTATATTTTTGC: GAAAGTGTATATTTTTGCG
ATTTAGCTACTCCTGTTTG: TTTAGCTACTCCTGTTTGT
GATACATTACAATAGCGAG: ATACATTACAATAGCGAGA
TAGCGAGAGTAAGAGGACT: AGCGAGAGTAAGAGGACTG
TATATTTTTGCGCAGTTAT: ATATTTTTGCGCAGTTATC
TGTTCCCGATCCTCCTCGC: GTTCCCGATCCTCCTCGCA
GAATAGCCTGAATCCAGAC: AATAGCCTGAATCCAGACT
CCTATTCCTAAATGCCAAT: CTATTCCTAAATGCCAATA
TTGACCGAGATTCCGGGTC: TGACCGAGATTCCGGGTCA
TCCAAGCAGTCTGCCGTGG: CCAAGCAGTCTGCCGTGGT
CAAAGCCTGATCTGATCAC: AAAGCCTGATCTGATCACA
AATAGCGAGAGTAAGAGGA: ATAGCGAGAGTAAGAGGAC
TTATCAGCTCGCGACGGCT: TATCAGCTCGCGACGGCTC
CAGGCCTATAAAGCCACCC: AGGCCTATAAAGCCACCCA
ACGGATGCATTTCAGAGGG: CGGATGCATTTCAGAGGGG
AACGTGCTAGGGAGGTAAA: ACGTGCTAGGGAGGTAAAG
ATGCAACCCAGACACTCCG: TGCAACCCAGACACTCCGA
GGTTTCCAGCCGCACAGCA: GTTTCCAGCCGCACAGCAT
AGCCTGGGAGGTGATGAAT: GCCTGGGAGGTGATGAATG
GCAACAATCCTATTCCTAA: CAACAATCCTATTCCTAAA
GATTCGGCACCAACATTCT: ATTCGGCACCAACATTCTG
GAGGAATTTGGTTGACCGA: AGGAATTTGGTTGACCGAG
GGGGTAGTTCCAATGAGGG: GGGTAGTTCCAATGAGGGC
TACTGGGGTAGTTCCAATG: ACTGGGGTAGTTCCAATGT
CACTACAGTATTTTCGTTC: ACTACAGTATTTTCGTTCA
AGCAGTCTGCCGTGGTACT: GCAGTCTGCCGTGGTACTT
TGAAGATTTCCTTCTGAAA: GAAGATTTCCTTCTGAAAG
TGTCACCTTGTTCAATGAG: GTCACCTTGTTCAATGAGA
GTTATATAAAAACGTGCTA: TTATATAAAAACGTGCTAG
AAACTAATGTACAAACCTC: AACTAATGTACAAACCTCT
CATGCTGTTTTAACACGTG: ATGCTGTTTTAACACGTGT
CTAGAGAGGGGGTAGTCCT: TAGAGAGGGGGTAGTCCTG
GTCACCTTGTTCAATGAGA: TCACCTTGTTCAATGAGAT
CTACATAGGCGTGCTCGTT: TACATAGGCGTGCTCGTTT
ACCATACTGGGGTAGTTCC: CCATACTGGGGTAGTTCCA
GGGTAGTTCCAATGCGAGG: GGTAGTTCCAATGCGAGGG
TACAGTATTTTCGTTCATG: ACAGTATTTTCGTTCATGA
AAGAGGACTGGGGTAGTTC: AGAGGACTGGGGTAGTTCC
CGTCGGGCTGGCCCAAAAC: GTCGGGCTGGCCCAAAACC
TTCGGCTAGACGGTTTATC: TCGGCTAGACGGTTTATCA
GTAGTTCCAATGGAATAAC: TAGTTCCAATGGAATAACA
AGATTCCGGGTCATGCTGT: GATTCCGGGTCATGCTGTT
CAGGTATCGAAAACTTGCG: AGGTATCGAAAACTTGCGC
ACGTCTTACACCCAAGATA: CGTCTTACACCCAAGATAC
CGAGATGACAGAGGCTGAC: GAGATGACAGAGGCTGACG
GGTACTTGTTCAACCGCGT: GTACTTGTTCAACCGCGTC
GTTCCAATGGAATAACATC: TTCCAATGGAATAACATCG
GCGATAAGGAGACCGCTTG: CGATAAGGAGACCGCTTGG
TGTGGCGATAAGGAGACCG: GTGGCGATAAGGAGACCGC
GCCGTTCATATTCAGGGAC: CCGTTCATATTCAGGGACA
CGATCTCGCCGCGCTTTGA: GATCTCGCCGCGCTTTGAT
AATAGCCTGAATCCAGACT: ATAGCCTGAATCCAGACTG
TTTAGCAACATTTAACAAG: TTAGCAACATTTAACAAGC
GGCTGGGCAACAAGTTCTC: GCTGGGCAACAAGTTCTCT
ATCCTATTCCTAAATGCCA: TCCTATTCCTAAATGCCAA
ACATCGAATTAGTCCTCGT: CATCGAATTAGTCCTCGTC
AGGTGGCGAGACAACGCAC: GGTGGCGAGACAACGCACA
GGGATTCGGCACCAACATT: GGATTCGGCACCAACATTC
TGTTAAAACCTTCCCCGAG: GTTAAAACCTTCCCCGAGG
AGTGTATATTTTTGCGCAG: GTGTATATTTTTGCGCAGT
GCATGTTGCTTGTGTCCGG: CATGTTGCTTGTGTCCGGG
ATTGCTCACTCTTTGAAGA: TTGCTCACTCTTTGAAGAG
ACAGGTACAGAATTTAGCT: CAGGTACAGAATTTAGCTA
TTGCTTGTGTCCGGGAGAG: TGCTTGTGTCCGGGAGAGG
CACGAGGGCTTGTAACAGT: ACGAGGGCTTGTAACAGTG
AAACCTTCCCCGAGGAATT: AACCTTCCCCGAGGAATTT
AATGTTCCCGATCCTCCTC: ATGTTCCCGATCCTCCTCG
CTTCTGAAAGTGTATATTT: TTCTGAAAGTGTATATTTT
CACTACATAGGCGTGCTCG: ACTACATAGGCGTGCTCGT
GCCGTATGACTCGAGATGA: CCGTATGACTCGAGATGAC
CAGTTTCCTTCGGAATTCA: AGTTTCCTTCGGAATTCAA
GATCGTGTTGTTAAAACCT: ATCGTGTTGTTAAAACCTT
ACATAGGCGTGCTCGTTTG: CATAGGCGTGCTCGTTTGC
ATGACTCGAGATGACAGAG: TGACTCGAGATGACAGAGG
CGTCATCACGTCCACGTTC: GTCATCACGTCCACGTTCG
ACGAGGGCTTGTAACAGTG: CGAGGGCTTGTAACAGTGC
AGGTCGCACTTTGATTGGA: GGTCGCACTTTGATTGGAA
AACTGTGAGTTGAACGTCT: ACTGTGAGTTGAACGTCTT
TACAGAATTTAGCTACTCC: ACAGAATTTAGCTACTCCT
TCTGAAAGTGTATATTTTT: CTGAAAGTGTATATTTTTG
CACCTTGTTCAATGAGATT: ACCTTGTTCAATGAGATTT
TTCCCGACGGATGCATTTC: TCCCGACGGATGCATTTCA
CCTCATTCGACATAATGTG: CTCATTCGACATAATGTGT
AGGCAGTCACAAGGAAACA: GGCAGTCACAAGGAAACAC
GTTCCCGACGGATGCATTT: TTCCCGACGGATGCATTTC
ATTACAATAGCGAGAGTAA: TTACAATAGCGAGAGTAAG
ACTAATCGAAAAACAGGTA: CTAATCGAAAAACAGGTAC
ATCAATGGTGGCTTCTGAT: TCAATGGTGGCTTCTGATC
TAGGGAGGTAAAGGTCGCA: AGGGAGGTAAAGGTCGCAC
CGTGGATTGCGAAGTGGCA: GTGGATTGCGAAGTGGCAA
ACGACGTCTTGCAAGGGCC: CGACGTCTTGCAAGGGCCC
TTCGCGGTCATGAAGATTT: TCGCGGTCATGAAGATTTC
AAAACGATGAGGGGCGCTT: AAACGATGAGGGGCGCTTA
ACTAATGTACAAACCTCTA: CTAATGTACAAACCTCTAT
AGAGGACTGGGGTAGTTCC: GAGGACTGGGGTAGTTCCA
CTGAGCGTTACGACGTGTT: TGAGCGTTACGACGTGTTT
TAAATGCCAATAAGCCGTC: AAATGCCAATAAGCCGTCT
CCACCGAATCCCTCGATCC: CACCGAATCCCTCGATCCA
CCTGGGAGGTGATGAATGT: CTGGGAGGTGATGAATGTA
TCACCTTGTCCATTCATAT: CACCTTGTCCATTCATATA
CGTTATATAAAAACGTGCT: GTTATATAAAAACGTGCTA
TCATGCTGTTTTAACACGT: CATGCTGTTTTAACACGTG
CTTGTCCATTCATATAGCT: TTGTCCATTCATATAGCTA
TACATAGGCGTGCTCGTTT: ACATAGGCGTGCTCGTTTG
AGTGCGATCACTGTTGTTA: GTGCGATCACTGTTGTTAT
CGCACTTTGATTGGAACGT: GCACTTTGATTGGAACGTC
GGCCCAGGTATCGAAAACT: GCCCAGGTATCGAAAACTT
GAAGAGTCCCGCCGGCAAC: AAGAGTCCCGCCGGCAACA
ATTTCGAACGAGACTCGAA: TTTCGAACGAGACTCGAAT
GGCTGCGTAGCTCTGAGCG: GCTGCGTAGCTCTGAGCGT
CTCGCAGGCTGGGCAACAT: TCGCAGGCTGGGCAACATT
CCGGAATAGAAGCTTAACG: CGGAATAGAAGCTTAACGC
CGAAAACATTGCTCACTCT: GAAAACATTGCTCACTCTT
TTCGTTCATGAGTTCGATT: TCGTTCATGAGTTCGATTA
CCTTCGGAATTCAACTTTA: CTTCGGAATTCAACTTTAG
GGTGAACCTGTCATATGGT: GTGAACCTGTCATATGGTA
TCAATGGTGGCTTCTGATC: CAATGGTGGCTTCTGATCG
CTTCTGATCGAGTGCGATC: TTCTGATCGAGTGCGATCA
GGCATGTAAGTACCGATTT: GCATGTAAGTACCGATTTC
CCGTATGGTGAAACCCTTA: CGTATGGTGAAACCCTTAT
AAGCATCTCGTGGCCCAGG: AGCATCTCGTGGCCCAGGT
TAGGGGTGACTAACTAATC: AGGGGTGACTAACTAATCG
AGGGCTGGGCTGAAGAAGG: GGGCTGGGCTGAAGAAGGC
GGGCTGAAGAAGGCTGCGT: GGCTGAAGAAGGCTGCGTA
CGTCGGGTTACAGCACCCG: GTCGGGTTACAGCACCCGC
ATTTATCAGCTCGCGACGG: TTTATCAGCTCGCGACGGC
ATTCGCGGTCATGAAGATT: TTCGCGGTCATGAAGATTT
AAAGCTAGAGAGGGGGTAG: AAGCTAGAGAGGGGGTAGT
CCTAAACTAATGTACAAAC: CTAAACTAATGTACAAACC
TAAAGGTCGCACTTTGATT: AAAGGTCGCACTTTGATTG
CCCGATCCTCCTCGCAGGC: CCGATCCTCCTCGCAGGCT
GGTATCGAAAACTTGCGCC: GTATCGAAAACTTGCGCCC
GGAATTTGGTTGACCGAGA: GAATTTGGTTGACCGAGAT
CTGGCCCAAAACCCAGACA: TGGCCCAAAACCCAGACAA
GTCCCGCCGGCAACACCCT: TCCCGCCGGCAACACCCTC
AACAAGCATCTCGTGGCCC: ACAAGCATCTCGTGGCCCA
TTTCGTTCATGAGTTCGAT: TTCGTTCATGAGTTCGATT
CCTGACTGTCGTCCCCTAA: CTGACTGTCGTCCCCTAAA
CTGAAAGTGTATATTTTTG: TGAAAGTGTATATTTTTGC
TTCGGTTCGATGCCCACCC: TCGGTTCGATGCCCACCCG
TACAACGTCCCGCCGTATG: ACAACGTCCCGCCGTATGA
GGAACGTCTTTTGTATCAG: GAACGTCTTTTGTATCAGT
TCGGAATTCAACTTTAGCA: CGGAATTCAACTTTAGCAA
AACACGTGTTGTAGGTCGA: ACACGTGTTGTAGGTCGAA
AAGTGTATATTTTTGCGCA: AGTGTATATTTTTGCGCAG
CGCGTTATATAAAAACGTG: GCGTTATATAAAAACGTGC
GAAGGCTACGCGTCGGGCT: AAGGCTACGCGTCGGGCTG
GCGAGACAACGCACATTCC: CGAGACAACGCACATTCCT
AGATGACAGAGGCTGACGG: GATGACAGAGGCTGACGGA
GTGCAATATGTGGCGATAA: TGCAATATGTGGCGATAAG
ATACGACGTCTTGCAAGGG: TACGACGTCTTGCAAGGGC
GTGAACCTGTCATATGGTA: TGAACCTGTCATATGGTAC
CACCCAGCTGCGTGTTGAT: ACCCAGCTGCGTGTTGATG
ATCCAGACTGATTCGCGGT: TCCAGACTGATTCGCGGTC
GTTGCTTGTGTCCGGGAGA: TTGCTTGTGTCCGGGAGAG
TTGTCCATTCATATAGCTA: TGTCCATTCATATAGCTAG
GCGCAGTTATCAATGGTGG: CGCAGTTATCAATGGTGGC
TGGCAACCATACTGGGGTA: GGCAACCATACTGGGGTAG
CTGAAGAAGGCTGCGTAGC: TGAAGAAGGCTGCGTAGCT
GGAAACACAGAGATCACTA: GAAACACAGAGATCACTAC
GCGCTTAGACTCGCTTGCA: CGCTTAGACTCGCTTGCAT
CGCAGGCTGGGCAACAGTT: GCAGGCTGGGCAACAGTTT
ACTTTAGCAACATTTAACA: CTTTAGCAACATTTAACAA
TCCAGGCAGTCACAAGGAA: CCAGGCAGTCACAAGGAAA
TGTATATTTTTGCGCAGTT: GTATATTTTTGCGCAGTTA
TTAAGTGGAAGGCTACGCG: TAAGTGGAAGGCTACGCGT
TACCATCGTTCACCTTGTC: ACCATCGTTCACCTTGTCC
TAGCCTGAATCCAGACTGA: AGCCTGAATCCAGACTGAT
GGGTAGTTCCAATGGAATA: GGTAGTTCCAATGGAATAA
ACTTGAAAAGTTGAAGCAC: CTTGAAAAGTTGAAGCACG
CGTGCTCGTTTGCGGCATG: GTGCTCGTTTGCGGCATGT
GTTCAATGAGATTTAACGG: TTCAATGAGATTTAACGGA
CGCTTGCATGCAACCCAGA: GCTTGCATGCAACCCAGAC
TATCTAGACTAAGGGCATG: ATCTAGACTAAGGGCATGT
TCGAACGAGACTCGAATAG: CGAACGAGACTCGAATAGC
CTGATCACACATTAGACTT: TGATCACACATTAGACTTG
CATTCTGCGAAGCAATCCA: ATTCTGCGAAGCAATCCAA
GATCCAGGCAGTCACAAGG: ATCCAGGCAGTCACAAGGA
TAAAACCAATCAACATCGA: AAAACCAATCAACATCGAA
AACGTCTTACACCCAAGAT: ACGTCTTACACCCAAGATA
GGACTGGGGTAGTTCCAAT: GACTGGGGTAGTTCCAATG
CGTAGCTCTGAGCGTTACG: GTAGCTCTGAGCGTTACGA
GTTTATCATTTCGAACGAG: TTTATCATTTCGAACGAGA
AGACACTCCGATCTCGCCG: GACACTCCGATCTCGCCGC
AAAGTCAGCCTCGGTTTCC: AAGTCAGCCTCGGTTTCCA
ATGGAATAACATCGCCTCG: TGGAATAACATCGCCTCGC
GATCACTGTTGTTATTTGC: ATCACTGTTGTTATTTGCT
GTACTGTCGCATGGGGCCG: TACTGTCGCATGGGGCCGC
TTGTGAATACAGTAGGAAA: TGTGAATACAGTAGGAAAT
ACTGATTCGCGGTCATGAA: CTGATTCGCGGTCATGAAG
ACTCCGATCTCGCCGCGCT: CTCCGATCTCGCCGCGCTT
GGCATAGGTTTAAATCTTG: GCATAGGTTTAAATCTTGC
ATCAGTACTGTCGCATGGG: TCAGTACTGTCGCATGGGG
CCGTTCATATTCAGGGACA: CGTTCATATTCAGGGACAC
CGCAGTTATCAATGGTGGC: GCAGTTATCAATGGTGGCT
GGAAATTTCGGTTGCCTGA: GAAATTTCGGTTGCCTGAC
GAAACCCTTATCAGTACTG: AAACCCTTATCAGTACTGT
CGGAATAGAAGCTTAACGC: GGAATAGAAGCTTAACGCG
TATCGAAAACTTGCGCCCA: ATCGAAAACTTGCGCCCAA
TTGCCTGTCTGTCGTTGCG: TGCCTGTCTGTCGTTGCGT
CATTAGACTTGAAAAGTTG: ATTAGACTTGAAAAGTTGA
TAGACGGTTTATCATTTCG: AGACGGTTTATCATTTCGA
TCATCACGTCCACGTTCGG: CATCACGTCCACGTTCGGT
TTACAGCACCCGCTCTTGC: TACAGCACCCGCTCTTGCC
TCGACATAATGTGTTTAAC: CGACATAATGTGTTTAACG
TTTCCCGAATCTGCCATGT: TTCCCGAATCTGCCATGTC
ATAATGAAAAGGCGATGCG: TAATGAAAAGGCGATGCGC
AAAAACGATGAGGGGCGCT: AAAACGATGAGGGGCGCTT
CACTTCACTACAGTATTTT: ACTTCACTACAGTATTTTC
TTTGCGCAGTTATCAATGG: TTGCGCAGTTATCAATGGT
GTCGAAAACATTGCTCACT: TCGAAAACATTGCTCACTC
GACGGATTCGAAATACGAC: ACGGATTCGAAATACGACG
AGCTCTGAGCGTTACGACG: GCTCTGAGCGTTACGACGT
TGAGTTGAACGTCTTACAC: GAGTTGAACGTCTTACACC
TTATTTGCTACAGCCGCGT: TATTTGCTACAGCCGCGTT
GCTTAGACTCGCTTGCATG: CTTAGACTCGCTTGCATGC
AGATTTAACGGATTCTGTC: GATTTAACGGATTCTGTCC
ATGTTCCCGATCCTCCTCG: TGTTCCCGATCCTCCTCGC
ACGATGAGGGGCGCTTAGA: CGATGAGGGGCGCTTAGAC
CCCTAAACTAATGTACAAA: CCTAAACTAATGTACAAAC
CGCGACGGCTCAGTACCGG: GCGACGGCTCAGTACCGGA
CTAATCGAAAAACAGGTAC: TAATCGAAAAACAGGTACA
ATCACTGTTGTTATTTGCT: TCACTGTTGTTATTTGCTA
AACTGGGGTAGTTCCAATG: ACTGGGGTAGTTCCAATGA
CCCGCTCTTGCCTCCTCAT: CCGCTCTTGCCTCCTCATT
GACGTGTTTGCAATGAAGA: ACGTGTTTGCAATGAAGAT
CTAGCGAGCACGACGGTGA: TAGCGAGCACGACGGTGAA
TCAGCTCGCGACGGCTCAG: CAGCTCGCGACGGCTCAGT
CCAGCTGCGTGTTGATGCA: CAGCTGCGTGTTGATGCAC
CATATAGCTAGGTTTCAGT: ATATAGCTAGGTTTCAGTG
AGGGCATGTAACCTTTCGG: GGGCATGTAACCTTTCGGC
GAATTCAACTTTAGCAACA: AATTCAACTTTAGCAACAT
GTTGAAGCACGTGTTGCAG: TTGAAGCACGTGTTGCAGT
CTGGGCAACATTTATCAGC: TGGGCAACATTTATCAGCT
CCATTCATATAGCTAGGTT: CATTCATATAGCTAGGTTT
TATTGCCTCCTTTAAGTGG: ATTGCCTCCTTTAAGTGGA
CCCCGCACCTCGCAGGCTG: CCCGCACCTCGCAGGCTGG
TACTGGGCATAGGTTTAAA: ACTGGGCATAGGTTTAAAT
GCTCTTGCCTCCTCATTCG: CTCTTGCCTCCTCATTCGA
GGCTAGACGGTTTATCATT: GCTAGACGGTTTATCATTT
CATGTAAGTACCGATTTCT: ATGTAAGTACCGATTTCTA
AGTGGAAGGCTACGCGTCG: GTGGAAGGCTACGCGTCGG
CGCCGCGCTTTGATTTCCC: GCCGCGCTTTGATTTCCCG
GTGTTTAACGATAATGAAA: TGTTTAACGATAATGAAAA
TGACTGTCGTCCCCTAAAC: GACTGTCGTCCCCTAAACT
CCCTTATCAGTACTGTCGC: CCTTATCAGTACTGTCGCA
TGTTGTAGGTCGAAAACAT: GTTGTAGGTCGAAAACATT
TACCGGAATAGAAGCTTAA: ACCGGAATAGAAGCTTAAC
TCCGCCCACATAGAAGCAA: CCGCCCACATAGAAGCAAA
CAAGGGCCCACCCTTAGGG: AAGGGCCCACCCTTAGGGC
AAGTTCTCTTAAATAAGTT: AGTTCTCTTAAATAAGTTG
TGCTACAGCCGCGTTATAT: GCTACAGCCGCGTTATATA
TAAGGGCATGTAACCTTTC: AAGGGCATGTAACCTTTCG
AGTTCGATTACAACGTCCC: GTTCGATTACAACGTCCCG
GGCAACAATCCTATTCCTA: GCAACAATCCTATTCCTAA
CGGCACCAACATTCTGCGA: GGCACCAACATTCTGCGAA
AAGGAGACCGCTTGGTAGG: AGGAGACCGCTTGGTAGGA
CTGACGGATTCGAAATACG: TGACGGATTCGAAATACGA
TAATCGAAAAACAGGTACA: AATCGAAAAACAGGTACAG
CCTCTATAGGTGGCGAGAC: CTCTATAGGTGGCGAGACA
TGGTACTGGGCATAGGTTT: GGTACTGGGCATAGGTTTA
CACGTTCGGTTCGATGCCC: ACGTTCGGTTCGATGCCCA
TAACTAATCGAAAAACAGG: AACTAATCGAAAAACAGGT
TTAACGGATTCTGTCCTAG: TAACGGATTCTGTCCTAGC
GGCAACCATACTGGGGTAG: GCAACCATACTGGGGTAGT
GCAACACCCTCCGCCCACA: CAACACCCTCCGCCCACAT
CCGCCTCCCACCGAATCCC: CGCCTCCCACCGAATCCCT
CCAATAAGCCGTCTTGCAC: CAATAAGCCGTCTTGCACT
TCCCGACGGATGCATTTCA: CCCGACGGATGCATTTCAG
GAGTAAGAGGACTGGGGTA: AGTAAGAGGACTGGGGTAG
GCTGGGCAACAAGTTCTCT: CTGGGCAACAAGTTCTCTT
TCCCTCGCAGGCTGGGCAA: CCCTCGCAGGCTGGGCAAC
CAGGCTGGGCAACAATCCT: AGGCTGGGCAACAATCCTA
GGGCTGGGCTGAAGAAGGC: GGCTGGGCTGAAGAAGGCT
TTTAACAAGCATCTCGTGG: TTAACAAGCATCTCGTGGC
ACCTTCCCCGAGGAATTTG: CCTTCCCCGAGGAATTTGG
CTCGCGACGGCTCAGTACC: TCGCGACGGCTCAGTACCG
CCGCGCTTTGATTTCCCGA: CGCGCTTTGATTTCCCGAA
TCTTGCAAGGGCCCACCCT: CTTGCAAGGGCCCACCCTT
GGGCTTGTAACAGTGCAAT: GGCTTGTAACAGTGCAATA
TATACCATCGTTCACCTTG: ATACCATCGTTCACCTTGT
AGGCTGGGCAACAGTTTCC: GGCTGGGCAACAGTTTCCT
CTCTTGTGAATACAGTAGG: TCTTGTGAATACAGTAGGA
ATACCATCGTTCACCTTGT: TACCATCGTTCACCTTGTC
GTACCGGAATAGAAGCTTA: TACCGGAATAGAAGCTTAA
ATGAAGATTTCCTTCTGAA: TGAAGATTTCCTTCTGAAA
TGGAATAACATCGCCTCGC: GGAATAACATCGCCTCGCA
TAACATCGCCTCGCAGGCT: AACATCGCCTCGCAGGCTG
CACAGAGATCACTACATAG: ACAGAGATCACTACATAGG
ACGGATTCGAAATACGACG: CGGATTCGAAATACGACGT
AACTAATCGAAAAACAGGT: ACTAATCGAAAAACAGGTA
GGACACAGCCTGGGAGGTG: GACACAGCCTGGGAGGTGA
CGGGCTGGCCCAAAACCCA: GGGCTGGCCCAAAACCCAG
ATGAGGGCCCCGCACCTCG: TGAGGGCCCCGCACCTCGC
ATTCGAAATACGACGTCTT: TTCGAAATACGACGTCTTG
TATTCCTAAATGCCAATAA: ATTCCTAAATGCCAATAAG
GAATAGAAGCTTAACGCGT: AATAGAAGCTTAACGCGTT
ACCCAGACAACTGTGAGTT: CCCAGACAACTGTGAGTTG
CAGTCACAAGGAAACACAG: AGTCACAAGGAAACACAGA
GCAGTCTGCCGTGGTACTT: CAGTCTGCCGTGGTACTTG
AGTGCAATATGTGGCGATA: GTGCAATATGTGGCGATAA
GTGTCCGGGAGAGGTGCCG: TGTCCGGGAGAGGTGCCGT
CTGGGGTAGTTCCAATGGA: TGGGGTAGTTCCAATGGAA
TGGGGTAGTTCCAATGTTC: GGGGTAGTTCCAATGTTCC
GGATTCTGTCCTAGCGGAG: GATTCTGTCCTAGCGGAGC
TCGAGATGACAGAGGCTGA: CGAGATGACAGAGGCTGAC
AGATGGGGATCGTGTTGTT: GATGGGGATCGTGTTGTTA
AAAACGTGCTAGGGAGGTA: AAACGTGCTAGGGAGGTAA
GTAAGAGGACTGGGGTAGT: TAAGAGGACTGGGGTAGTT
CGCGTCATCACGTCCACGT: GCGTCATCACGTCCACGTT
TCCGATCTCGCCGCGCTTT: CCGATCTCGCCGCGCTTTG
AAGAGTCCCGCCGGCAACA: AGAGTCCCGCCGGCAACAC
ATTTCGGTTGCCTGACTGT: TTTCGGTTGCCTGACTGTC
CCTCCTCGCAGGCTGGGCA: CTCCTCGCAGGCTGGGCAA
AGAGATCACTACATAGGCG: GAGATCACTACATAGGCGT
ATCACACATTAGACTTGAA: TCACACATTAGACTTGAAA
CGTTCATATTCAGGGACAC: GTTCATATTCAGGGACACT
ATGCCAATAAGCCGTCTTG: TGCCAATAAGCCGTCTTGC
AGACTGATTCGCGGTCATG: GACTGATTCGCGGTCATGA
CGAGGAATTTGGTTGACCG: GAGGAATTTGGTTGACCGA
GCCTGATCTGATCACACAT: CCTGATCTGATCACACATT
TCAGTGTCACAGACCACCA: CAGTGTCACAGACCACCAA
GGCTTCTGATCGAGTGCGA: GCTTCTGATCGAGTGCGAT
CGAGGGCTTGTAACAGTGC: GAGGGCTTGTAACAGTGCA
GTCGCATGGGGCCGCCTCC: TCGCATGGGGCCGCCTCCC
CAGTGCAATATGTGGCGAT: AGTGCAATATGTGGCGATA
GTTGATGCACGAGGGCTTG: TTGATGCACGAGGGCTTGT
TCCAGTGTCAACTGGGGTA: CCAGTGTCAACTGGGGTAG
CAGGCAGTCACAAGGAAAC: AGGCAGTCACAAGGAAACA
GCAACCATACTGGGGTAGT: CAACCATACTGGGGTAGTT
AGCCGCACAGCATGTTGCT: GCCGCACAGCATGTTGCTT
TTTTAACACGTGTTGTAGG: TTTAACACGTGTTGTAGGT
GGCAGTCACAAGGAAACAC: GCAGTCACAAGGAAACACA
CTACGCGTCGGGCTGGCCC: TACGCGTCGGGCTGGCCCA
GCTATACCATCGTTCACCT: CTATACCATCGTTCACCTT
GCACAGCATGTTGCTTGTG: CACAGCATGTTGCTTGTGT
TACAGCACCCGCTCTTGCC: ACAGCACCCGCTCTTGCCT
TGAAGAAGGCTGCGTAGCT: GAAGAAGGCTGCGTAGCTC
CCACATAGAAGCAAAGCCT: CACATAGAAGCAAAGCCTG
GGGAGAGGTGCCGTATGGT: GGAGAGGTGCCGTATGGTG
CATATCTAGACTAAGGGCA: ATATCTAGACTAAGGGCAT
GCTTGTAACAGTGCAATAT: CTTGTAACAGTGCAATATG
GCGAAGTGGCAACCATACT: CGAAGTGGCAACCATACTG
CCCGGGCTGATCTTACACT: CCGGGCTGATCTTACACTT
AAGGCTACGCGTCGGGCTG: AGGCTACGCGTCGGGCTGG
ACCTCTATAGGTGGCGAGA: CCTCTATAGGTGGCGAGAC
CTTGCACTTATACGTGGAT: TTGCACTTATACGTGGATT
AGTTCCAATGCGAGGGTCT: GTTCCAATGCGAGGGTCTT
CCTCGGTTTCCAGCCGCAC: CTCGGTTTCCAGCCGCACA
CTTGTTCAATGAGATTTAA: TTGTTCAATGAGATTTAAC
GCCTATAAAGCCACCCAGC: CCTATAAAGCCACCCAGCT
CTGTCGCATGGGGCCGCCT: TGTCGCATGGGGCCGCCTC
TATTTTTGCGCAGTTATCA: ATTTTTGCGCAGTTATCAA
AGCTGCGTGTTGATGCACG: GCTGCGTGTTGATGCACGA
CATCTCGTGGCCCAGGTAT: ATCTCGTGGCCCAGGTATC
TAGGAAATTTCGGTTGCCT: AGGAAATTTCGGTTGCCTG
TAGAAGCAAAGCCTGATCT: AGAAGCAAAGCCTGATCTG
TGGGGTAGTTCCAATGGAA: GGGGTAGTTCCAATGGAAT
TGCCTGACTGTCGTCCCCT: GCCTGACTGTCGTCCCCTA
AGAGAGGGGGTAGTCCTGA: GAGAGGGGGTAGTCCTGAG
TACATTACAATAGCGAGAG: ACATTACAATAGCGAGAGT
CAGCTCGCGACGGCTCAGT: AGCTCGCGACGGCTCAGTA
GAGGGCCCCGCACCTCGCA: AGGGCCCCGCACCTCGCAG
AACCGCGTCATCACGTCCA: ACCGCGTCATCACGTCCAC
CTCCCACCGAATCCCTCGA: TCCCACCGAATCCCTCGAT
GTGTCAACTGGGGTAGTTC: TGTCAACTGGGGTAGTTCC
CTAGGGGTGACTAACTAAT: TAGGGGTGACTAACTAATC
CGCCTCGCAGGCTGGGCAA: GCCTCGCAGGCTGGGCAAC
GTTGTTATTTGCTACAGCC: TTGTTATTTGCTACAGCCG
GCTGGGCAACAATCCTATT: CTGGGCAACAATCCTATTC
AATGGAATAACATCGCCTC: ATGGAATAACATCGCCTCG
TTTGCTACAGCCGCGTTAT: TTGCTACAGCCGCGTTATA
CAAAAAGTCAGCCTCGGTT: AAAAAGTCAGCCTCGGTTT
GAAGCAAAGCCTGATCTGA: AAGCAAAGCCTGATCTGAT
GTCATGAAGATTTCCTTCT: TCATGAAGATTTCCTTCTG
CCAATGTTCCCGATCCTCC: CAATGTTCCCGATCCTCCT
CCACACCATATCTAGACTA: CACACCATATCTAGACTAA
AGATACATTACAATAGCGA: GATACATTACAATAGCGAG
TGTTTGCAATGAAGATGGG: GTTTGCAATGAAGATGGGG
AGGAAATTTCGGTTGCCTG: GGAAATTTCGGTTGCCTGA
AGTTGTCGCTTGCCTGTCT: GTTGTCGCTTGCCTGTCTG
TTTTGCGCAGTTATCAATG: TTTGCGCAGTTATCAATGG
CCGGGTCATGCTGTTTTAA: CGGGTCATGCTGTTTTAAC
TTGAAAAGTTGAAGCACGT: TGAAAAGTTGAAGCACGTG
TGCTCACTCTTTGAAGAGT: GCTCACTCTTTGAAGAGTC
CAATAGCGAGAGTAAGAGG: AATAGCGAGAGTAAGAGGA
CCTCGATCCAGGCAGTCAC: CTCGATCCAGGCAGTCACA
GAGATTTAACGGATTCTGT: AGATTTAACGGATTCTGTC
CCGCACAGCATGTTGCTTG: CGCACAGCATGTTGCTTGT
GTCTTTTGTATCAGTGTCA: TCTTTTGTATCAGTGTCAC
GTCATGCTGTTTTAACACG: TCATGCTGTTTTAACACGT
CGGATTCTGTCCTAGCGGA: GGATTCTGTCCTAGCGGAG
GTGGCAACCATACTGGGGT: TGGCAACCATACTGGGGTA
AGTGGTGAATGTCACCTTG: GTGGTGAATGTCACCTTGT
TGTGTTTAACGATAATGAA: GTGTTTAACGATAATGAAA
AACACAGAGATCACTACAT: ACACAGAGATCACTACATA
TCCAATGAGGGCCCCGCAC: CCAATGAGGGCCCCGCACC
GCTGAAGAAGGCTGCGTAG: CTGAAGAAGGCTGCGTAGC
AGGTTTAAATCTTGCTTTC: GGTTTAAATCTTGCTTTCA
TGCGCTATACCATCGTTCA: GCGCTATACCATCGTTCAC
CTGGGCAACAGTTTCCTTC: TGGGCAACAGTTTCCTTCG
CTTGTAACAGTGCAATATG: TTGTAACAGTGCAATATGT
CTAAAACCAATCAACATCG: TAAAACCAATCAACATCGA
GCACTTATACGTGGATTGC: CACTTATACGTGGATTGCG
ATAAGGAGACCGCTTGGTA: TAAGGAGACCGCTTGGTAG
GAAGCTTAACGCGTTCCCG: AAGCTTAACGCGTTCCCGA
GGGTGACTAACTAATCGAA: GGTGACTAACTAATCGAAA
GTGTTGTTAAAACCTTCCC: TGTTGTTAAAACCTTCCCC
TCGCAGGCTGGGCAACAAT: CGCAGGCTGGGCAACAATC
GGGGTAGTCCTGAGGACAC: GGGTAGTCCTGAGGACACA
ATCGAGTGCGATCACTGTT: TCGAGTGCGATCACTGTTG
CGAAAAACAGGTACAGAAT: GAAAAACAGGTACAGAATT
ACAGAGATCACTACATAGG: CAGAGATCACTACATAGGC
GAGACAACGCACATTCCTA: AGACAACGCACATTCCTAG
TGCCGTTCATATTCAGGGA: GCCGTTCATATTCAGGGAC
AGACAACTGTGAGTTGAAC: GACAACTGTGAGTTGAACG
CGAAAACTTGCGCCCAAAA: GAAAACTTGCGCCCAAAAG
TTACACCCAAGATACATTA: TACACCCAAGATACATTAC
CTCTTTGAAGAGTCCCGCC: TCTTTGAAGAGTCCCGCCG
AGAGGCTGACGGATTCGAA: GAGGCTGACGGATTCGAAA
AATCCAAGCAGTCTGCCGT: ATCCAAGCAGTCTGCCGTG
TGTGAATACAGTAGGAAAT: GTGAATACAGTAGGAAATT
TCTGTCGTTGCGTGGCTCT: CTGTCGTTGCGTGGCTCTT
AGGCGATGCGCTATACCAT: GGCGATGCGCTATACCATC
CGCAGGCTGGGCAACATTT: GCAGGCTGGGCAACATTTA
ACAACGTCCCGCCGTATGA: CAACGTCCCGCCGTATGAC
GTTGCCTGACTGTCGTCCC: TTGCCTGACTGTCGTCCCC
TTGTGTCCGGGAGAGGTGC: TGTGTCCGGGAGAGGTGCC
CCGTGGTACTTGTTCAACC: CGTGGTACTTGTTCAACCG
ACCCTTATCAGTACTGTCG: CCCTTATCAGTACTGTCGC
TTAACGATAATGAAAAGGC: TAACGATAATGAAAAGGCG
TCATTTCGAACGAGACTCG: CATTTCGAACGAGACTCGA
GCGGTCATGAAGATTTCCT: CGGTCATGAAGATTTCCTT
CGGGAGAGGTGCCGTATGG: GGGAGAGGTGCCGTATGGT
GGCCTATAAAGCCACCCAG: GCCTATAAAGCCACCCAGC
GGCTGGGCTGAAGAAGGCT: GCTGGGCTGAAGAAGGCTG
TCGCAGGCTGGGCAACAAG: CGCAGGCTGGGCAACAAGT
TGCCAAGCCCCACACCATA: GCCAAGCCCCACACCATAT
CTGTTTGTATTGCCTCCTT: TGTTTGTATTGCCTCCTTT
CATTCGACATAATGTGTTT: ATTCGACATAATGTGTTTA
TCAACTGGGGTAGTTCCAA: CAACTGGGGTAGTTCCAAT
GAAAAACGATGAGGGGCGC: AAAAACGATGAGGGGCGCT
GCGTCGGGCTGGCCCAAAA: CGTCGGGCTGGCCCAAAAC
TTCAGGGACACTGGGGTAG: TCAGGGACACTGGGGTAGT
ACAATCCTATTCCTAAATG: CAATCCTATTCCTAAATGC
TGTCGTTGCGTGGCTCTTG: GTCGTTGCGTGGCTCTTGT
GGGGCGCTTAGACTCGCTT: GGGCGCTTAGACTCGCTTG
CATAGAAGCAAAGCCTGAT: ATAGAAGCAAAGCCTGATC
AAGGCTGCGTAGCTCTGAG: AGGCTGCGTAGCTCTGAGC
GTCTTACACCCAAGATACA: TCTTACACCCAAGATACAT
GATTTCCCGAATCTGCCAT: ATTTCCCGAATCTGCCATG
TGGGCAACAATCCTATTCC: GGGCAACAATCCTATTCCT
ACATAGAAGCAAAGCCTGA: CATAGAAGCAAAGCCTGAT
GGAGGTAAAGGTCGCACTT: GAGGTAAAGGTCGCACTTT
ACATAATGTGTTTAACGAT: CATAATGTGTTTAACGATA
TTTCCTTCGGAATTCAACT: TTCCTTCGGAATTCAACTT
TCGTCGGGTTACAGCACCC: CGTCGGGTTACAGCACCCG
TGCAATGAAGATGGGGATC: GCAATGAAGATGGGGATCG
CTCGGTTTCCAGCCGCACA: TCGGTTTCCAGCCGCACAG
TGGCTTCTGATCGAGTGCG: GGCTTCTGATCGAGTGCGA
GCCTGTCTGTCGTTGCGTG: CCTGTCTGTCGTTGCGTGG
CCGGCAACACCCTCCGCCC: CGGCAACACCCTCCGCCCA
GGCTCTTGTGAATACAGTA: GCTCTTGTGAATACAGTAG
GTGTTGTAGGTCGAAAACA: TGTTGTAGGTCGAAAACAT
TCATGAAGATTTCCTTCTG: CATGAAGATTTCCTTCTGA
CCGCCCACATAGAAGCAAA: CGCCCACATAGAAGCAAAG
CCTCCTTTAAGTGGAAGGC: CTCCTTTAAGTGGAAGGCT
CAATCAACATCGAATTAGT: AATCAACATCGAATTAGTC
TAACGGATTCTGTCCTAGC: AACGGATTCTGTCCTAGCG
TGGGCAACAAGTTCTCTTA: GGGCAACAAGTTCTCTTAA
TACTTGTTCAACCGCGTCA: ACTTGTTCAACCGCGTCAT
GCAATATGTGGCGATAAGG: CAATATGTGGCGATAAGGA
TTGAAGAGTCCCGCCGGCA: TGAAGAGTCCCGCCGGCAA
CTCGCAGGCTGGGCAACAA: TCGCAGGCTGGGCAACAAG TCGCAGGCTGGGCAACAAT
GTAAGTACCGATTTCTAGC: TAAGTACCGATTTCTAGCG
CGAATTAGTCCTCGTCGGG: GAATTAGTCCTCGTCGGGT
CTGCCGTGGTACTTGTTCA: TGCCGTGGTACTTGTTCAA
GCACCTCGCAGGCTGGGCA: CACCTCGCAGGCTGGGCAA
GCCTCGGTTTCCAGCCGCA: CCTCGGTTTCCAGCCGCAC
ACACGTGTTGTAGGTCGAA: CACGTGTTGTAGGTCGAAA
GCCCACATAGAAGCAAAGC: CCCACATAGAAGCAAAGCC
CCTTCTGAAAGTGTATATT: CTTCTGAAAGTGTATATTT
GCTGGGCTGAAGAAGGCTG: CTGGGCTGAAGAAGGCTGC
TGAATCCAGACTGATTCGC: GAATCCAGACTGATTCGCG
CCAGTGTCAACTGGGGTAG: CAGTGTCAACTGGGGTAGT
CTGTCGTTGCGTGGCTCTT: TGTCGTTGCGTGGCTCTTG
CACCCTCCGCCCACATAGA: ACCCTCCGCCCACATAGAA
GTATCGAAAACTTGCGCCC: TATCGAAAACTTGCGCCCA
GGACACTGGGGTAGTTCCA: GACACTGGGGTAGTTCCAA
TCACTGTTGTTATTTGCTA: CACTGTTGTTATTTGCTAC
CAAGATACATTACAATAGC: AAGATACATTACAATAGCG
CTCTATAGGTGGCGAGACA: TCTATAGGTGGCGAGACAA
CATTTATCAGCTCGCGACG: ATTTATCAGCTCGCGACGG
ATTAGACTTGAAAAGTTGA: TTAGACTTGAAAAGTTGAA
TTGCCTCCTTTAAGTGGAA: TGCCTCCTTTAAGTGGAAG
TCGGGCTGGCCCAAAACCC: CGGGCTGGCCCAAAACCCA
GCCCACCCTTAGGGCTGGG: CCCACCCTTAGGGCTGGGC
TCTAACCCTAAAACCAATC: CTAACCCTAAAACCAATCA
GACGTCTTGCAAGGGCCCA: ACGTCTTGCAAGGGCCCAC
CCGCGTCATCACGTCCACG: CGCGTCATCACGTCCACGT
CGGGTCATGCTGTTTTAAC: GGGTCATGCTGTTTTAACA
ACGTGTTTGCAATGAAGAT: CGTGTTTGCAATGAAGATG
TCACAAGGAAACACAGAGA: CACAAGGAAACACAGAGAT
GTTCCCGATCCTCCTCGCA: TTCCCGATCCTCCTCGCAG
GCCACCCAGCTGCGTGTTG: CCACCCAGCTGCGTGTTGA
AGGGGATTCGGCACCAACA: GGGGATTCGGCACCAACAT
TCCATTCATATAGCTAGGT: CCATTCATATAGCTAGGTT
TGGCTCTTGTGAATACAGT: GGCTCTTGTGAATACAGTA
ATTCGACATAATGTGTTTA: TTCGACATAATGTGTTTAA
GGTGGCTTCTGATCGAGTG: GTGGCTTCTGATCGAGTGC
TCATATGGTACTGGGCATA: CATATGGTACTGGGCATAG
ACCCAGACACTCCGATCTC: CCCAGACACTCCGATCTCG
TAGTCCTGAGGACACAGCC: AGTCCTGAGGACACAGCCT
TCATGGACAGGCCTATAAA: CATGGACAGGCCTATAAAG
CCCACATAGAAGCAAAGCC: CCACATAGAAGCAAAGCCT
AATTAGTCCTCGTCGGGTT: ATTAGTCCTCGTCGGGTTA
TGATCTTACACTTCACTAC: GATCTTACACTTCACTACA
AGCACCCGCTCTTGCCTCC: GCACCCGCTCTTGCCTCCT
AATCAACATCGAATTAGTC: ATCAACATCGAATTAGTCC
TCGTGTTGTTAAAACCTTC: CGTGTTGTTAAAACCTTCC
ACAGCACCCGCTCTTGCCT: CAGCACCCGCTCTTGCCTC
CTATAGGTGGCGAGACAAC: TATAGGTGGCGAGACAACG
GGCGCTTAGACTCGCTTGC: GCGCTTAGACTCGCTTGCA
AATAAGTTGTCGCTTGCCT: ATAAGTTGTCGCTTGCCTG
ACAAGGAAACACAGAGATC: CAAGGAAACACAGAGATCA
AAAACAGGTACAGAATTTA: AAACAGGTACAGAATTTAG
CATGTTGCTTGTGTCCGGG: ATGTTGCTTGTGTCCGGGA
GTCGGGTTACAGCACCCGC: TCGGGTTACAGCACCCGCT
AGGAGACCGCTTGGTAGGA: GGAGACCGCTTGGTAGGAA
TGGGGATCGTGTTGTTAAA: GGGGATCGTGTTGTTAAAA
CGCTCTTGCCTCCTCATTC: GCTCTTGCCTCCTCATTCG
CGGCTAGACGGTTTATCAT: GGCTAGACGGTTTATCATT
TGTTGCAGTCTAACCCTAA: GTTGCAGTCTAACCCTAAA
ATGGGGATCGTGTTGTTAA: TGGGGATCGTGTTGTTAAA
TGGTACTTGTTCAACCGCG: GGTACTTGTTCAACCGCGT
CATTGCTCACTCTTTGAAG: ATTGCTCACTCTTTGAAGA
CATCGTTCACCTTGTCCAT: ATCGTTCACCTTGTCCATT
GTCACAGACCACCAAGGGA: TCACAGACCACCAAGGGAG
AACCTTCCCCGAGGAATTT: ACCTTCCCCGAGGAATTTG
GCACGTGTTGCAGTCTAAC: CACGTGTTGCAGTCTAACC
GATAAGGAGACCGCTTGGT: ATAAGGAGACCGCTTGGTA
TCCACGTTCGGTTCGATGC: CCACGTTCGGTTCGATGCC
AAAAGTCAGCCTCGGTTTC: AAAGTCAGCCTCGGTTTCC
GGGATCGTGTTGTTAAAAC: GGATCGTGTTGTTAAAACC
CAACCATACTGGGGTAGTT: AACCATACTGGGGTAGTTC
ACGATAATGAAAAGGCGAT: CGATAATGAAAAGGCGATG
AGACTCGAATAGCCTGAAT: GACTCGAATAGCCTGAATC
GGTCGCACTTTGATTGGAA: GTCGCACTTTGATTGGAAC
GCGAAGCAATCCAAGCAGT: CGAAGCAATCCAAGCAGTC
GACACAGCCTGGGAGGTGA: ACACAGCCTGGGAGGTGAT
ATACATTACAATAGCGAGA: TACATTACAATAGCGAGAG
GTGTTGCAGTCTAACCCTA: TGTTGCAGTCTAACCCTAA
CTGCGAAGCAATCCAAGCA: TGCGAAGCAATCCAAGCAG
TTCCAATGAGGGCCCCGCA: TCCAATGAGGGCCCCGCAC
ACACTTCACTACAGTATTT: CACTTCACTACAGTATTTT
CGAATAGCCTGAATCCAGA: GAATAGCCTGAATCCAGAC
GCACCAACATTCTGCGAAG: CACCAACATTCTGCGAAGC
TAGAAGCTTAACGCGTTCC: AGAAGCTTAACGCGTTCCC
AGCTCGCGACGGCTCAGTA: GCTCGCGACGGCTCAGTAC
ACTCGCTTGCATGCAACCC: CTCGCTTGCATGCAACCCA
TTTGATTGGAACGTCTTTT: TTGATTGGAACGTCTTTTG
AAGAAGGCTGCGTAGCTCT: AGAAGGCTGCGTAGCTCTG
TGGCGAGACAACGCACATT: GGCGAGACAACGCACATTC
AGACTCGCTTGCATGCAAC: GACTCGCTTGCATGCAACC
GTGAATGTCACCTTGTTCA: TGAATGTCACCTTGTTCAA
ACTACATAGGCGTGCTCGT: CTACATAGGCGTGCTCGTT
TCGGTTTCCAGCCGCACAG: CGGTTTCCAGCCGCACAGC
TTGCGAAGTGGCAACCATA: TGCGAAGTGGCAACCATAC
TTAACGCGTTCCCGACGGA: TAACGCGTTCCCGACGGAT
AGAATTTAGCTACTCCTGT: GAATTTAGCTACTCCTGTT
TATACGTGGATTGCGAAGT: ATACGTGGATTGCGAAGTG
TCGCTTGCATGCAACCCAG: CGCTTGCATGCAACCCAGA
TGAGGACACAGCCTGGGAG: GAGGACACAGCCTGGGAGG
CTGCGTGTTGATGCACGAG: TGCGTGTTGATGCACGAGG
TTAAATCTTGCTTTCATGG: TAAATCTTGCTTTCATGGA
TTCCAATGCGAGGGTCTTC: TCCAATGCGAGGGTCTTCC
GGCGATAAGGAGACCGCTT: GCGATAAGGAGACCGCTTG
TTGCTCACTCTTTGAAGAG: TGCTCACTCTTTGAAGAGT
GTCGGGCTGGCCCAAAACC: TCGGGCTGGCCCAAAACCC
AGTCCCGCCGGCAACACCC: GTCCCGCCGGCAACACCCT
TAGGTTTAAATCTTGCTTT: AGGTTTAAATCTTGCTTTC
CTTATACGTGGATTGCGAA: TTATACGTGGATTGCGAAG
AGGCTACGCGTCGGGCTGG: GGCTACGCGTCGGGCTGGC
AGCTACTCCTGTTTGTATT: GCTACTCCTGTTTGTATTG
AACACCCTCCGCCCACATA: ACACCCTCCGCCCACATAG
TTCAACCGCGTCATCACGT: TCAACCGCGTCATCACGTC
ACGTCTTTTGTATCAGTGT: CGTCTTTTGTATCAGTGTC
CTGCGTAGCTCTGAGCGTT: TGCGTAGCTCTGAGCGTTA
TTCCTAGGGGTGACTAACT: TCCTAGGGGTGACTAACTA
CGCAGGCTGGGCAACAATC: GCAGGCTGGGCAACAATCC
TCGAAATACGACGTCTTGC: CGAAATACGACGTCTTGCA
TGGTTGACCGAGATTCCGG: GGTTGACCGAGATTCCGGG
TAAGCCGTCTTGCACTTAT: AAGCCGTCTTGCACTTATA
TCTAGCGAGCACGACGGTG: CTAGCGAGCACGACGGTGA
TCGCAGGCTGGGCAACATT: CGCAGGCTGGGCAACATTT
ATGGTACTGGGCATAGGTT: TGGTACTGGGCATAGGTTT
ACGCACATTCCTAGGGGTG: CGCACATTCCTAGGGGTGA
TTAGCTACTCCTGTTTGTA: TAGCTACTCCTGTTTGTAT
CCGCCGGCAACACCCTCCG: CGCCGGCAACACCCTCCGC
CTTGAAAAGTTGAAGCACG: TTGAAAAGTTGAAGCACGT
CTGTCGTCCCCTAAACTAA: TGTCGTCCCCTAAACTAAT
ATTCCTAAATGCCAATAAG: TTCCTAAATGCCAATAAGC
TGGGGTAGTTCCAATGAGG: GGGGTAGTTCCAATGAGGG
GCCGCGCTTTGATTTCCCG: CCGCGCTTTGATTTCCCGA
CACTCTTTGAAGAGTCCCG: ACTCTTTGAAGAGTCCCGC
TATCAGTACTGTCGCATGG: ATCAGTACTGTCGCATGGG
TTAAATAAGTTGTCGCTTG: TAAATAAGTTGTCGCTTGC
ACAGTAGGAAATTTCGGTT: CAGTAGGAAATTTCGGTTG
ACCCGCTCTTGCCTCCTCA: CCCGCTCTTGCCTCCTCAT
CTAGGTTTCAGTGGTGAAT: TAGGTTTCAGTGGTGAATG
TTGAACGTCTTACACCCAA: TGAACGTCTTACACCCAAG
ACCGCTTGGTAGGAATGCC: CCGCTTGGTAGGAATGCCA
CAAGGAAACACAGAGATCA: AAGGAAACACAGAGATCAC
TTTAAATCTTGCTTTCATG: TTAAATCTTGCTTTCATGG
GCTCGCGACGGCTCAGTAC: CTCGCGACGGCTCAGTACC
ACGACGTGTTTGCAATGAA: CGACGTGTTTGCAATGAAG
AATCTTGCTTTCATGGACA: ATCTTGCTTTCATGGACAG
ATGCCCACCCGGGCTGATC: TGCCCACCCGGGCTGATCT
CAGGCTGGGCAACATTTAT: AGGCTGGGCAACATTTATC
TTGTAACAGTGCAATATGT: TGTAACAGTGCAATATGTG
AATTTGGTTGACCGAGATT: ATTTGGTTGACCGAGATTC
ACAGCCTGGGAGGTGATGA: CAGCCTGGGAGGTGATGAA
AACAGTTTCCTTCGGAATT: ACAGTTTCCTTCGGAATTC
CAATGGAATAACATCGCCT: AATGGAATAACATCGCCTC
ATGGTGGCTTCTGATCGAG: TGGTGGCTTCTGATCGAGT
ACAGCCGCGTTATATAAAA: CAGCCGCGTTATATAAAAA
TTGGAACGTCTTTTGTATC: TGGAACGTCTTTTGTATCA
TCCTCCTCGCAGGCTGGGC: CCTCCTCGCAGGCTGGGCA
TGCAAGGGCCCACCCTTAG: GCAAGGGCCCACCCTTAGG
TCTTACACTTCACTACAGT: CTTACACTTCACTACAGTA
AATTTCGGTTGCCTGACTG: ATTTCGGTTGCCTGACTGT
ACAGTATTTTCGTTCATGA: CAGTATTTTCGTTCATGAG
ACTGTTGTTATTTGCTACA: CTGTTGTTATTTGCTACAG
AAGCTAGAGAGGGGGTAGT: AGCTAGAGAGGGGGTAGTC
CAAACCTCTATAGGTGGCG: AAACCTCTATAGGTGGCGA
CTCCTGTTTGTATTGCCTC: TCCTGTTTGTATTGCCTCC
TGCCTCCTTTAAGTGGAAG: GCCTCCTTTAAGTGGAAGG
TAACAAGCATCTCGTGGCC: AACAAGCATCTCGTGGCCC
AGTAGGAAATTTCGGTTGC: GTAGGAAATTTCGGTTGCC
TCCAATGCGAGGGTCTTCC: CCAATGCGAGGGTCTTCCC
CTTCCCTCGCAGGCTGGGC: TTCCCTCGCAGGCTGGGCA
TACAGCCGCGTTATATAAA: ACAGCCGCGTTATATAAAA
CAACAAGTTCTCTTAAATA: AACAAGTTCTCTTAAATAA
ATTTGCTACAGCCGCGTTA: TTTGCTACAGCCGCGTTAT
TACAGTAGGAAATTTCGGT: ACAGTAGGAAATTTCGGTT
GTTTAACGATAATGAAAAG: TTTAACGATAATGAAAAGG
ATAAAAACGTGCTAGGGAG: TAAAAACGTGCTAGGGAGG
CCACCCAGCTGCGTGTTGA: CACCCAGCTGCGTGTTGAT
ACTGGGGTAGTTCCAATGT: CTGGGGTAGTTCCAATGTT
GGGGTGACTAACTAATCGA: GGGTGACTAACTAATCGAA
CATTACAATAGCGAGAGTA: ATTACAATAGCGAGAGTAA
GCTGTTTTAACACGTGTTG: CTGTTTTAACACGTGTTGT
CGAATCTGCCATGTCCAGT: GAATCTGCCATGTCCAGTG
TAAGTACCGATTTCTAGCG: AAGTACCGATTTCTAGCGA
CAGCCGCACAGCATGTTGC: AGCCGCACAGCATGTTGCT
TCGTGGCCCAGGTATCGAA: CGTGGCCCAGGTATCGAAA
GGTGCCGTATGGTGAAACC: GTGCCGTATGGTGAAACCC
GACTGATTCGCGGTCATGA: ACTGATTCGCGGTCATGAA
GTCATCACGTCCACGTTCG: TCATCACGTCCACGTTCGG
TCGCGGTCATGAAGATTTC: CGCGGTCATGAAGATTTCC
TGCACTTATACGTGGATTG: GCACTTATACGTGGATTGC
CGATCCAGGCAGTCACAAG: GATCCAGGCAGTCACAAGG
TCGTCCCCTAAACTAATGT: CGTCCCCTAAACTAATGTA
CAATGAGGGCCCCGCACCT: AATGAGGGCCCCGCACCTC
GGTCGAAAACATTGCTCAC: GTCGAAAACATTGCTCACT
TTTGAAGAGTCCCGCCGGC: TTGAAGAGTCCCGCCGGCA
AACGATAATGAAAAGGCGA: ACGATAATGAAAAGGCGAT
TAAGGAGACCGCTTGGTAG: AAGGAGACCGCTTGGTAGG
TGAATACAGTAGGAAATTT: GAATACAGTAGGAAATTTC
CATTCATATAGCTAGGTTT: ATTCATATAGCTAGGTTTC
CATGGGGCCGCCTCCCACC: ATGGGGCCGCCTCCCACCG
GGGCCCACCCTTAGGGCTG: GGCCCACCCTTAGGGCTGG
TTTCGAACGAGACTCGAAT: TTCGAACGAGACTCGAATA
CCAGACACTCCGATCTCGC: CAGACACTCCGATCTCGCC
GCTTGCATGCAACCCAGAC: CTTGCATGCAACCCAGACA
GACACTGGGGTAGTTCCAA: ACACTGGGGTAGTTCCAAT
GGAGACCGCTTGGTAGGAA: GAGACCGCTTGGTAGGAAT
ATCCCTCGATCCAGGCAGT: TCCCTCGATCCAGGCAGTC
TAGCTCTGAGCGTTACGAC: AGCTCTGAGCGTTACGACG
GGCTGAAGAAGGCTGCGTA: GCTGAAGAAGGCTGCGTAG
ATTACAACGTCCCGCCGTA: TTACAACGTCCCGCCGTAT
GTCAACTGGGGTAGTTCCA: TCAACTGGGGTAGTTCCAA
ACGTCCCGCCGTATGACTC: CGTCCCGCCGTATGACTCG
GGAGCTCAAAAAGTCAGCC: GAGCTCAAAAAGTCAGCCT
TCTTACACCCAAGATACAT: CTTACACCCAAGATACATT
GCTTCTGATCGAGTGCGAT: CTTCTGATCGAGTGCGATC
ACAAGTTCTCTTAAATAAG: CAAGTTCTCTTAAATAAGT
CAGTAGGAAATTTCGGTTG: AGTAGGAAATTTCGGTTGC
GCGGAGCTCAAAAAGTCAG: CGGAGCTCAAAAAGTCAGC
CCGCTCTTGCCTCCTCATT: CGCTCTTGCCTCCTCATTC
ACACAGCCTGGGAGGTGAT: CACAGCCTGGGAGGTGATG
CCGTCTTGCACTTATACGT: CGTCTTGCACTTATACGTG
TGTCGCTTGCCTGTCTGTC: GTCGCTTGCCTGTCTGTCG
CAAAAGCTAGAGAGGGGGT: AAAAGCTAGAGAGGGGGTA
CCTCGTCGGGTTACAGCAC: CTCGTCGGGTTACAGCACC
GAGACCGCTTGGTAGGAAT: AGACCGCTTGGTAGGAATG
ATGTGGCGATAAGGAGACC: TGTGGCGATAAGGAGACCG
GACAACGCACATTCCTAGG: ACAACGCACATTCCTAGGG
TTGTTAAAACCTTCCCCGA: TGTTAAAACCTTCCCCGAG
GTACTTGTTCAACCGCGTC: TACTTGTTCAACCGCGTCA
GAGTTGGGTCGAAAAACGA: AGTTGGGTCGAAAAACGAT
TTAGACTTGAAAAGTTGAA: TAGACTTGAAAAGTTGAAG
GCTCAAAAAGTCAGCCTCG: CTCAAAAAGTCAGCCTCGG
CAGTACTGTCGCATGGGGC: AGTACTGTCGCATGGGGCC
AGCAATCCAAGCAGTCTGC: GCAATCCAAGCAGTCTGCC
AAACGATGAGGGGCGCTTA: AACGATGAGGGGCGCTTAG
AGGCTGACGGATTCGAAAT: GGCTGACGGATTCGAAATA
AGAGTCCCGCCGGCAACAC: GAGTCCCGCCGGCAACACC
AAACGTGCTAGGGAGGTAA: AACGTGCTAGGGAGGTAAA
TGCTCGTTTGCGGCATGTA: GCTCGTTTGCGGCATGTAA
GTCTGTCGTTGCGTGGCTC: TCTGTCGTTGCGTGGCTCT
ATTTTTGCGCAGTTATCAA: TTTTTGCGCAGTTATCAAT
CAGAATTTAGCTACTCCTG: AGAATTTAGCTACTCCTGT
CTGCCATGTCCAGTGTCAA: TGCCATGTCCAGTGTCAAC
CGTTCGGTTCGATGCCCAC: GTTCGGTTCGATGCCCACC
TCAGTACTGTCGCATGGGG: CAGTACTGTCGCATGGGGC
GCAACATTTAACAAGCATC: CAACATTTAACAAGCATCT
CACCCTTAGGGCTGGGCTG: ACCCTTAGGGCTGGGCTGA
TCTCGTGGCCCAGGTATCG: CTCGTGGCCCAGGTATCGA
TTTCGGCTAGACGGTTTAT: TTCGGCTAGACGGTTTATC
GGTGGCGAGACAACGCACA: GTGGCGAGACAACGCACAT
GAACGAGACTCGAATAGCC: AACGAGACTCGAATAGCCT
GACGGTGAACCTGTCATAT: ACGGTGAACCTGTCATATG
TCCCGCCGGCAACACCCTC: CCCGCCGGCAACACCCTCC
TATCAGTGTCACAGACCAC: ATCAGTGTCACAGACCACC
AACCTGTCATATGGTACTG: ACCTGTCATATGGTACTGG
TAGCGAGCACGACGGTGAA: AGCGAGCACGACGGTGAAC
GGGCCGCCTCCCACCGAAT: GGCCGCCTCCCACCGAATC
AACCAATCAACATCGAATT: ACCAATCAACATCGAATTA
CGTGTTGTTAAAACCTTCC: GTGTTGTTAAAACCTTCCC
TTGGGTCGAAAAACGATGA: TGGGTCGAAAAACGATGAG
CACATTAGACTTGAAAAGT: ACATTAGACTTGAAAAGTT
GGTAGTTCCAATGAGGGCC: GTAGTTCCAATGAGGGCCC
ATGTGTTTAACGATAATGA: TGTGTTTAACGATAATGAA
CTCCTCATTCGACATAATG: TCCTCATTCGACATAATGT
AGAGTAAGAGGACTGGGGT: GAGTAAGAGGACTGGGGTA
GAGGGTCTTCCCTCGCAGG: AGGGTCTTCCCTCGCAGGC
CTCTTAAATAAGTTGTCGC: TCTTAAATAAGTTGTCGCT
GAATAACATCGCCTCGCAG: AATAACATCGCCTCGCAGG
GAATTAGTCCTCGTCGGGT: AATTAGTCCTCGTCGGGTT
TTCTCTTAAATAAGTTGTC: TCTCTTAAATAAGTTGTCG
AGCGAGCACGACGGTGAAC: GCGAGCACGACGGTGAACC
AGGCTGGGCAACAATCCTA: GGCTGGGCAACAATCCTAT
CACCAACATTCTGCGAAGC: ACCAACATTCTGCGAAGCA
TCCCCTAAACTAATGTACA: CCCCTAAACTAATGTACAA
AAAGTTGAAGCACGTGTTG: AAGTTGAAGCACGTGTTGC
CGAGACAACGCACATTCCT: GAGACAACGCACATTCCTA
TTCCCTCGCAGGCTGGGCA: TCCCTCGCAGGCTGGGCAA
TTCCCGATCCTCCTCGCAG: TCCCGATCCTCCTCGCAGG
ATACTGGGGTAGTTCCAAT: TACTGGGGTAGTTCCAATG
ATCGCCTCGCAGGCTGGGC: TCGCCTCGCAGGCTGGGCA
GGTAAAGGTCGCACTTTGA: GTAAAGGTCGCACTTTGAT
CGAGATTCCGGGTCATGCT: GAGATTCCGGGTCATGCTG
CCTGAGGACACAGCCTGGG: CTGAGGACACAGCCTGGGA
GCTAGGGAGGTAAAGGTCG: CTAGGGAGGTAAAGGTCGC
GTTGTTAAAACCTTCCCCG: TTGTTAAAACCTTCCCCGA
TAGCGGAGCTCAAAAAGTC: AGCGGAGCTCAAAAAGTCA
GGTTGCCTGACTGTCGTCC: GTTGCCTGACTGTCGTCCC
AATGTACAAACCTCTATAG: ATGTACAAACCTCTATAGG
CAAAACCCAGACAACTGTG: AAAACCCAGACAACTGTGA
GCTTAACGCGTTCCCGACG: CTTAACGCGTTCCCGACGG
GCCCCGCACCTCGCAGGCT: CCCCGCACCTCGCAGGCTG
GCAACAAGTTCTCTTAAAT: CAACAAGTTCTCTTAAATA
CCCAGACAACTGTGAGTTG: CCAGACAACTGTGAGTTGA
TTCTAGCGAGCACGACGGT: TCTAGCGAGCACGACGGTG
CCTGATCTGATCACACATT: CTGATCTGATCACACATTA
ACAAACCTCTATAGGTGGC: CAAACCTCTATAGGTGGCG
AAACCCAGACAACTGTGAG: AACCCAGACAACTGTGAGT
CTGGGGTAGTTCCAATGTT: TGGGGTAGTTCCAATGTTC
CTGATCTTACACTTCACTA: TGATCTTACACTTCACTAC
TCAACCGCGTCATCACGTC: CAACCGCGTCATCACGTCC
CCCGAATCTGCCATGTCCA: CCGAATCTGCCATGTCCAG
CTGAGGACACAGCCTGGGA: TGAGGACACAGCCTGGGAG
GACAACTGTGAGTTGAACG: ACAACTGTGAGTTGAACGT
CTTGGTAGGAATGCCAAGC: TTGGTAGGAATGCCAAGCC
TCCTGAGGACACAGCCTGG: CCTGAGGACACAGCCTGGG
ATCACTACATAGGCGTGCT: TCACTACATAGGCGTGCTC
ATACGTGGATTGCGAAGTG: TACGTGGATTGCGAAGTGG
CCTTGTTCAATGAGATTTA: CTTGTTCAATGAGATTTAA
AACCATACTGGGGTAGTTC: ACCATACTGGGGTAGTTCC
CATCGCCTCGCAGGCTGGG: ATCGCCTCGCAGGCTGGGC
AACATTGCTCACTCTTTGA: ACATTGCTCACTCTTTGAA
CATAGGCGTGCTCGTTTGC: ATAGGCGTGCTCGTTTGCG
CACCATATCTAGACTAAGG: ACCATATCTAGACTAAGGG
CCTGTCATATGGTACTGGG: CTGTCATATGGTACTGGGC
AAAACCAATCAACATCGAA: AAACCAATCAACATCGAAT
AAAAAGTCAGCCTCGGTTT: AAAAGTCAGCCTCGGTTTC
TCGAATTAGTCCTCGTCGG: CGAATTAGTCCTCGTCGGG
TTTAACGATAATGAAAAGG: TTAACGATAATGAAAAGGC
CGGTGAACCTGTCATATGG: GGTGAACCTGTCATATGGT
CCAGGCAGTCACAAGGAAA: CAGGCAGTCACAAGGAAAC
TGATTTCCCGAATCTGCCA: GATTTCCCGAATCTGCCAT
TATGGTACTGGGCATAGGT: ATGGTACTGGGCATAGGTT
TGTCATATGGTACTGGGCA: GTCATATGGTACTGGGCAT
GAGCTCAAAAAGTCAGCCT: AGCTCAAAAAGTCAGCCTC
TAGTTCCAATGTTCCCGAT: AGTTCCAATGTTCCCGATC
TGTCCTAGCGGAGCTCAAA: GTCCTAGCGGAGCTCAAAA
TGGCGATAAGGAGACCGCT: GGCGATAAGGAGACCGCTT
AAAAGCTAGAGAGGGGGTA: AAAGCTAGAGAGGGGGTAG
ACCGAATCCCTCGATCCAG: CCGAATCCCTCGATCCAGG
CAGGGACACTGGGGTAGTT: AGGGACACTGGGGTAGTTC
ACCGATTTCTAGCGAGCAC: CCGATTTCTAGCGAGCACG
CGCGTTCCCGACGGATGCA: GCGTTCCCGACGGATGCAT
ACACATTAGACTTGAAAAG: CACATTAGACTTGAAAAGT
CTTGCTTTCATGGACAGGC: TTGCTTTCATGGACAGGCC
CTCTGAGCGTTACGACGTG: TCTGAGCGTTACGACGTGT
TCGAAAACATTGCTCACTC: CGAAAACATTGCTCACTCT
TGCGCCCAAAAGCTAGAGA: GCGCCCAAAAGCTAGAGAG
TCTTTTGTATCAGTGTCAC: CTTTTGTATCAGTGTCACA
GCCGTGGTACTTGTTCAAC: CCGTGGTACTTGTTCAACC
CCCGCCGGCAACACCCTCC: CCGCCGGCAACACCCTCCG
AGTCAGCCTCGGTTTCCAG: GTCAGCCTCGGTTTCCAGC
ATCTCGCCGCGCTTTGATT: TCTCGCCGCGCTTTGATTT
GATGGGGATCGTGTTGTTA: ATGGGGATCGTGTTGTTAA
TGGGCAACAGTTTCCTTCG: GGGCAACAGTTTCCTTCGG
AAAACTTGCGCCCAAAAGC: AAACTTGCGCCCAAAAGCT
TGAGGGGCGCTTAGACTCG: GAGGGGCGCTTAGACTCGC
AAGGGCATGTAACCTTTCG: AGGGCATGTAACCTTTCGG
CAGTATTTTCGTTCATGAG: AGTATTTTCGTTCATGAGT
TCATGAGTTCGATTACAAC: CATGAGTTCGATTACAACG
CACAGCCTGGGAGGTGATG: ACAGCCTGGGAGGTGATGA
AGTCCTCGTCGGGTTACAG: GTCCTCGTCGGGTTACAGC
TCCCGAATCTGCCATGTCC: CCCGAATCTGCCATGTCCA
CTCGTTTGCGGCATGTAAG: TCGTTTGCGGCATGTAAGT
GTGTTTGCAATGAAGATGG: TGTTTGCAATGAAGATGGG
CAATGCGAGGGTCTTCCCT: AATGCGAGGGTCTTCCCTC
GGTAGTCCTGAGGACACAG: GTAGTCCTGAGGACACAGC
GTGGCGAGACAACGCACAT: TGGCGAGACAACGCACATT
TGAAGAGTCCCGCCGGCAA: GAAGAGTCCCGCCGGCAAC
ACTTGCGCCCAAAAGCTAG: CTTGCGCCCAAAAGCTAGA
CAGCCGCGTTATATAAAAA: AGCCGCGTTATATAAAAAC
CGGAGCTCAAAAAGTCAGC: GGAGCTCAAAAAGTCAGCC
TGAAAAGTTGAAGCACGTG: GAAAAGTTGAAGCACGTGT
GCTTTGATTTCCCGAATCT: CTTTGATTTCCCGAATCTG
TCGCACTTTGATTGGAACG: CGCACTTTGATTGGAACGT
ATTCGGCACCAACATTCTG: TTCGGCACCAACATTCTGC
GTAACCTTTCGGCTAGACG: TAACCTTTCGGCTAGACGG
TCGATGCCCACCCGGGCTG: CGATGCCCACCCGGGCTGA
AATACGACGTCTTGCAAGG: ATACGACGTCTTGCAAGGG
AGGGGGTAGTCCTGAGGAC: GGGGGTAGTCCTGAGGACA
AGCAAAGCCTGATCTGATC: GCAAAGCCTGATCTGATCA
AACATCGCCTCGCAGGCTG: ACATCGCCTCGCAGGCTGG
GGGTTACAGCACCCGCTCT: GGTTACAGCACCCGCTCTT
GAATCCAGACTGATTCGCG: AATCCAGACTGATTCGCGG
GCACATTCCTAGGGGTGAC: CACATTCCTAGGGGTGACT
GAGATGACAGAGGCTGACG: AGATGACAGAGGCTGACGG
ATCTTACACTTCACTACAG: TCTTACACTTCACTACAGT
TGTCTGTCGTTGCGTGGCT: GTCTGTCGTTGCGTGGCTC
GCTTGCCTGTCTGTCGTTG: CTTGCCTGTCTGTCGTTGC
ACACTGGGGTAGTTCCAAT: CACTGGGGTAGTTCCAATG
GGTTTCAGTGGTGAATGTC: GTTTCAGTGGTGAATGTCA
CTATACCATCGTTCACCTT: TATACCATCGTTCACCTTG
GAAGCACGTGTTGCAGTCT: AAGCACGTGTTGCAGTCTA
AGGGCCCACCCTTAGGGCT: GGGCCCACCCTTAGGGCTG
GCCTGACTGTCGTCCCCTA: CCTGACTGTCGTCCCCTAA
TTTATCATTTCGAACGAGA: TTATCATTTCGAACGAGAC
GTCACAAGGAAACACAGAG: TCACAAGGAAACACAGAGA
GGGTAGTTCCAATGAGGGC: GGTAGTTCCAATGAGGGCC
GAGGGGATTCGGCACCAAC: AGGGGATTCGGCACCAACA
GGCTGATCTTACACTTCAC: GCTGATCTTACACTTCACT
TAAGTGGAAGGCTACGCGT: AAGTGGAAGGCTACGCGTC
CGTGGCTCTTGTGAATACA: GTGGCTCTTGTGAATACAG
CAAGCAGTCTGCCGTGGTA: AAGCAGTCTGCCGTGGTAC
TGACAGAGGCTGACGGATT: GACAGAGGCTGACGGATTC
GGCAACATTTATCAGCTCG: GCAACATTTATCAGCTCGC
CAATAAGCCGTCTTGCACT: AATAAGCCGTCTTGCACTT
AAGCAATCCAAGCAGTCTG: AGCAATCCAAGCAGTCTGC
TTGATTTCCCGAATCTGCC: TGATTTCCCGAATCTGCCA
TGTTGTTATTTGCTACAGC: GTTGTTATTTGCTACAGCC
ACGGATTCTGTCCTAGCGG: CGGATTCTGTCCTAGCGGA
CGCTTGCCTGTCTGTCGTT: GCTTGCCTGTCTGTCGTTG
TTAACACGTGTTGTAGGTC: TAACACGTGTTGTAGGTCG
GACTGTCGTCCCCTAAACT: ACTGTCGTCCCCTAAACTA
AGGCCTATAAAGCCACCCA: GGCCTATAAAGCCACCCAG
AGTACTGTCGCATGGGGCC: GTACTGTCGCATGGGGCCG
GAGATCACTACATAGGCGT: AGATCACTACATAGGCGTG
CGAAGCAATCCAAGCAGTC: GAAGCAATCCAAGCAGTCT
CTTCCCCGAGGAATTTGGT: TTCCCCGAGGAATTTGGTT
ACTCGAATAGCCTGAATCC: CTCGAATAGCCTGAATCCA
GCAACAGTTTCCTTCGGAA: CAACAGTTTCCTTCGGAAT
GAAAGTGTATATTTTTGCG: AAAGTGTATATTTTTGCGC
TGTACAAACCTCTATAGGT: GTACAAACCTCTATAGGTG
CGTCTTGCACTTATACGTG: GTCTTGCACTTATACGTGG
TAAGAGGACTGGGGTAGTT: AAGAGGACTGGGGTAGTTC
GAATGCCAAGCCCCACACC: AATGCCAAGCCCCACACCA
ATGCATTTCAGAGGGGATT: TGCATTTCAGAGGGGATTC
GAAACACAGAGATCACTAC: AAACACAGAGATCACTACA
ATCAGCTCGCGACGGCTCA: TCAGCTCGCGACGGCTCAG
GATTGGAACGTCTTTTGTA: ATTGGAACGTCTTTTGTAT
GAGGACTGGGGTAGTTCCA: AGGACTGGGGTAGTTCCAA
GGGCCCCGCACCTCGCAGG: GGCCCCGCACCTCGCAGGC
CATGTAACCTTTCGGCTAG: ATGTAACCTTTCGGCTAGA
GCGGCATGTAAGTACCGAT: CGGCATGTAAGTACCGATT
GGTTACAGCACCCGCTCTT: GTTACAGCACCCGCTCTTG
CTTTGATTTCCCGAATCTG: TTTGATTTCCCGAATCTGC
CTGATTCGCGGTCATGAAG: TGATTCGCGGTCATGAAGA
TCGGCTAGACGGTTTATCA: CGGCTAGACGGTTTATCAT
TTACAACGTCCCGCCGTAT: TACAACGTCCCGCCGTATG
TATTTGCTACAGCCGCGTT: ATTTGCTACAGCCGCGTTA
TCCTTCTGAAAGTGTATAT: CCTTCTGAAAGTGTATATT
AAGGAAACACAGAGATCAC: AGGAAACACAGAGATCACT
CGTGGCCCAGGTATCGAAA: GTGGCCCAGGTATCGAAAA
TCAATGAGATTTAACGGAT: CAATGAGATTTAACGGATT
CCAGGTATCGAAAACTTGC: CAGGTATCGAAAACTTGCG
TCTTGCCTCCTCATTCGAC: CTTGCCTCCTCATTCGACA
CTGTCTGTCGTTGCGTGGC: TGTCTGTCGTTGCGTGGCT
GCTGGCCCAAAACCCAGAC: CTGGCCCAAAACCCAGACA
CGCGCTTTGATTTCCCGAA: GCGCTTTGATTTCCCGAAT
TCCCCGAGGAATTTGGTTG: CCCCGAGGAATTTGGTTGA
TGGTGGCTTCTGATCGAGT: GGTGGCTTCTGATCGAGTG
CATTTCAGAGGGGATTCGG: ATTTCAGAGGGGATTCGGC
GGTTTATCATTTCGAACGA: GTTTATCATTTCGAACGAG
AACCCAGACACTCCGATCT: ACCCAGACACTCCGATCTC
GACGGCTCAGTACCGGAAT: ACGGCTCAGTACCGGAATA
GATCCTCCTCGCAGGCTGG: ATCCTCCTCGCAGGCTGGG
TTGTTCAACCGCGTCATCA: TGTTCAACCGCGTCATCAC
TCTGCCGTGGTACTTGTTC: CTGCCGTGGTACTTGTTCA
TCCTAGCGGAGCTCAAAAA: CCTAGCGGAGCTCAAAAAG
TTGATTGGAACGTCTTTTG: TGATTGGAACGTCTTTTGT
TGAGGGCCCCGCACCTCGC: GAGGGCCCCGCACCTCGCA
GGCGATGCGCTATACCATC: GCGATGCGCTATACCATCG
TCCTTTAAGTGGAAGGCTA: CCTTTAAGTGGAAGGCTAC
GGATTCGAAATACGACGTC: GATTCGAAATACGACGTCT
CAACTGTGAGTTGAACGTC: AACTGTGAGTTGAACGTCT
TCGCCGCGCTTTGATTTCC: CGCCGCGCTTTGATTTCCC
GAGTTCGATTACAACGTCC: AGTTCGATTACAACGTCCC
ATAATGTGTTTAACGATAA: TAATGTGTTTAACGATAAT
AGAGGTGCCGTATGGTGAA: GAGGTGCCGTATGGTGAAA
TCTCGCCGCGCTTTGATTT: CTCGCCGCGCTTTGATTTC
TTCATATAGCTAGGTTTCA: TCATATAGCTAGGTTTCAG
GCCAATAAGCCGTCTTGCA: CCAATAAGCCGTCTTGCAC
AGACAACGCACATTCCTAG: GACAACGCACATTCCTAGG
TGAAACCCTTATCAGTACT: GAAACCCTTATCAGTACTG
CGATAAGGAGACCGCTTGG: GATAAGGAGACCGCTTGGT
GCCTCCTTTAAGTGGAAGG: CCTCCTTTAAGTGGAAGGC
ACAGAGGCTGACGGATTCG: CAGAGGCTGACGGATTCGA
CCACCCGGGCTGATCTTAC: CACCCGGGCTGATCTTACA
AATGTCACCTTGTTCAATG: ATGTCACCTTGTTCAATGA
CACCCGGGCTGATCTTACA: ACCCGGGCTGATCTTACAC
TCAGCCTCGGTTTCCAGCC: CAGCCTCGGTTTCCAGCCG
GTCGTTGCGTGGCTCTTGT: TCGTTGCGTGGCTCTTGTG
TCGGGTTACAGCACCCGCT: CGGGTTACAGCACCCGCTC
CCCGACGGATGCATTTCAG: CCGACGGATGCATTTCAGA
AATACAGTAGGAAATTTCG: ATACAGTAGGAAATTTCGG
GGGCTGGCCCAAAACCCAG: GGCTGGCCCAAAACCCAGA
GCACTTTGATTGGAACGTC: CACTTTGATTGGAACGTCT
AGGGTCTTCCCTCGCAGGC: GGGTCTTCCCTCGCAGGCT
GCGTTCCCGACGGATGCAT: CGTTCCCGACGGATGCATT
CCTTATCAGTACTGTCGCA: CTTATCAGTACTGTCGCAT
AACTAATGTACAAACCTCT: ACTAATGTACAAACCTCTA
TGCATGCAACCCAGACACT: GCATGCAACCCAGACACTC
GTGGCCCAGGTATCGAAAA: TGGCCCAGGTATCGAAAAC
TGGAAGGCTACGCGTCGGG: GGAAGGCTACGCGTCGGGC
AACAATCCTATTCCTAAAT: ACAATCCTATTCCTAAATG
TAAACTAATGTACAAACCT: AAACTAATGTACAAACCTC
TGCAGTCTAACCCTAAAAC: GCAGTCTAACCCTAAAACC
AGCCCCACACCATATCTAG: GCCCCACACCATATCTAGA
TTCCGGGTCATGCTGTTTT: TCCGGGTCATGCTGTTTTA
TACACCCAAGATACATTAC: ACACCCAAGATACATTACA
ACGCGTCGGGCTGGCCCAA: CGCGTCGGGCTGGCCCAAA
AGGCGTGCTCGTTTGCGGC: GGCGTGCTCGTTTGCGGCA
TTGCTACAGCCGCGTTATA: TGCTACAGCCGCGTTATAT
CGCACCTCGCAGGCTGGGC: GCACCTCGCAGGCTGGGCA
TTTAAGTGGAAGGCTACGC: TTAAGTGGAAGGCTACGCG
AGTATTTTCGTTCATGAGT: GTATTTTCGTTCATGAGTT
CTTTAGCAACATTTAACAA: TTTAGCAACATTTAACAAG
CTCACTCTTTGAAGAGTCC: TCACTCTTTGAAGAGTCCC
TTCACTACAGTATTTTCGT: TCACTACAGTATTTTCGTT
CAGCATGTTGCTTGTGTCC: AGCATGTTGCTTGTGTCCG
CTTCGGAATTCAACTTTAG: TTCGGAATTCAACTTTAGC
TTTGTATCAGTGTCACAGA: TTGTATCAGTGTCACAGAC
AGTGTCACAGACCACCAAG: GTGTCACAGACCACCAAGG
GGCTGGGCAACAATCCTAT: GCTGGGCAACAATCCTATT
GTTCCAATGTTCCCGATCC: TTCCAATGTTCCCGATCCT
TTTATCAGCTCGCGACGGC: TTATCAGCTCGCGACGGCT
AACATTCTGCGAAGCAATC: ACATTCTGCGAAGCAATCC
CCATACTGGGGTAGTTCCA: CATACTGGGGTAGTTCCAA
ATAGAAGCTTAACGCGTTC: TAGAAGCTTAACGCGTTCC
GAACGTCTTTTGTATCAGT: AACGTCTTTTGTATCAGTG
CTGTGAGTTGAACGTCTTA: TGTGAGTTGAACGTCTTAC
AACATTTAACAAGCATCTC: ACATTTAACAAGCATCTCG
ATTTCCTTCTGAAAGTGTA: TTTCCTTCTGAAAGTGTAT
CGCCTCCCACCGAATCCCT: GCCTCCCACCGAATCCCTC
GATCGAGTGCGATCACTGT: ATCGAGTGCGATCACTGTT
GAAGCAATCCAAGCAGTCT: AAGCAATCCAAGCAGTCTG
GTTGTCGCTTGCCTGTCTG: TTGTCGCTTGCCTGTCTGT
GTCATATGGTACTGGGCAT: TCATATGGTACTGGGCATA
AAGCCCCACACCATATCTA: AGCCCCACACCATATCTAG
AGTTATCAATGGTGGCTTC: GTTATCAATGGTGGCTTCT
TGGTAGGAATGCCAAGCCC: GGTAGGAATGCCAAGCCCC
TTGCAATGAAGATGGGGAT: TGCAATGAAGATGGGGATC
CCCAAAACCCAGACAACTG: CCAAAACCCAGACAACTGT
CAGTGTCAACTGGGGTAGT: AGTGTCAACTGGGGTAGTT
CGTCCCGCCGTATGACTCG: GTCCCGCCGTATGACTCGA
GTCCCCTAAACTAATGTAC: TCCCCTAAACTAATGTACA
GCGAGGGTCTTCCCTCGCA: CGAGGGTCTTCCCTCGCAG
AGAGGGGGTAGTCCTGAGG: GAGGGGGTAGTCCTGAGGA
AAACCTCTATAGGTGGCGA: AACCTCTATAGGTGGCGAG
AGCTCAAAAAGTCAGCCTC: GCTCAAAAAGTCAGCCTCG
CGGGCTGATCTTACACTTC: GGGCTGATCTTACACTTCA
GAATCTGCCATGTCCAGTG: AATCTGCCATGTCCAGTGT
GGGGTAGTTCCAATGGAAT: GGGTAGTTCCAATGGAATA
TTGCGCCCAAAAGCTAGAG: TGCGCCCAAAAGCTAGAGA
CACCCAAGATACATTACAA: ACCCAAGATACATTACAAT
AGCCGCGTTATATAAAAAC: GCCGCGTTATATAAAAACG
TCGTTGCGTGGCTCTTGTG: CGTTGCGTGGCTCTTGTGA
GCTACAGCCGCGTTATATA: CTACAGCCGCGTTATATAA
GTAGGAAATTTCGGTTGCC: TAGGAAATTTCGGTTGCCT
GTGGCGATAAGGAGACCGC: TGGCGATAAGGAGACCGCT
TGTCGTCCCCTAAACTAAT: GTCGTCCCCTAAACTAATG
TGTCACAGACCACCAAGGG: GTCACAGACCACCAAGGGA
GACACTCCGATCTCGCCGC: ACACTCCGATCTCGCCGCG
CAAGGGAGTTGGGTCGAAA: AAGGGAGTTGGGTCGAAAA
TCTAGACTAAGGGCATGTA: CTAGACTAAGGGCATGTAA
CGCCGTATGACTCGAGATG: GCCGTATGACTCGAGATGA
GATTTCTAGCGAGCACGAC: ATTTCTAGCGAGCACGACG
AAAAGGCGATGCGCTATAC: AAAGGCGATGCGCTATACC
GAAAAACAGGTACAGAATT: AAAAACAGGTACAGAATTT
GTGTCACAGACCACCAAGG: TGTCACAGACCACCAAGGG
ATTCTGCGAAGCAATCCAA: TTCTGCGAAGCAATCCAAG
AAACAGGTACAGAATTTAG: AACAGGTACAGAATTTAGC
GCAGTCACAAGGAAACACA: CAGTCACAAGGAAACACAG
CAACTGGGGTAGTTCCAAT: AACTGGGGTAGTTCCAATG
CTGTCATATGGTACTGGGC: TGTCATATGGTACTGGGCA
CTTGCCTGTCTGTCGTTGC: TTGCCTGTCTGTCGTTGCG
TGTTCAATGAGATTTAACG: GTTCAATGAGATTTAACGG
CTTTTGTATCAGTGTCACA: TTTTGTATCAGTGTCACAG
AGTTCCAATGTTCCCGATC: GTTCCAATGTTCCCGATCC
TAGGAATGCCAAGCCCCAC: AGGAATGCCAAGCCCCACA
AAAGTGTATATTTTTGCGC: AAGTGTATATTTTTGCGCA
TTGCCTCCTCATTCGACAT: TGCCTCCTCATTCGACATA
CGGTTGCCTGACTGTCGTC: GGTTGCCTGACTGTCGTCC
AATCCCTCGATCCAGGCAG: ATCCCTCGATCCAGGCAGT
GAAATTTCGGTTGCCTGAC: AAATTTCGGTTGCCTGACT
TGCCGTATGGTGAAACCCT: GCCGTATGGTGAAACCCTT
GCGTAGCTCTGAGCGTTAC: CGTAGCTCTGAGCGTTACG
CGAGGGTCTTCCCTCGCAG: GAGGGTCTTCCCTCGCAGG
CCCCTAAACTAATGTACAA: CCCTAAACTAATGTACAAA
CCGAATCTGCCATGTCCAG: CGAATCTGCCATGTCCAGT
GCATCTCGTGGCCCAGGTA: CATCTCGTGGCCCAGGTAT
ACGGTGAACCTGTCATATG: CGGTGAACCTGTCATATGG
GGCCCACCCTTAGGGCTGG: GCCCACCCTTAGGGCTGGG
TGTAGGTCGAAAACATTGC: GTAGGTCGAAAACATTGCT
TTCGGCACCAACATTCTGC: TCGGCACCAACATTCTGCG
CAGTCTAACCCTAAAACCA: AGTCTAACCCTAAAACCAA
GGCAACAAGTTCTCTTAAA: GCAACAAGTTCTCTTAAAT
GAACGTCTTACACCCAAGA: AACGTCTTACACCCAAGAT
CCCTCCGCCCACATAGAAG: CCTCCGCCCACATAGAAGC
AATCCAGACTGATTCGCGG: ATCCAGACTGATTCGCGGT
CCATCGTTCACCTTGTCCA: CATCGTTCACCTTGTCCAT
AAACATTGCTCACTCTTTG: AACATTGCTCACTCTTTGA
CCATGTCCAGTGTCAACTG: CATGTCCAGTGTCAACTGG
AAACTTGCGCCCAAAAGCT: AACTTGCGCCCAAAAGCTA
TCTGCGAAGCAATCCAAGC: CTGCGAAGCAATCCAAGCA
TCACAGACCACCAAGGGAG: CACAGACCACCAAGGGAGT
GTTACGACGTGTTTGCAAT: TTACGACGTGTTTGCAATG
TCTTGCTTTCATGGACAGG: CTTGCTTTCATGGACAGGC
CGTCCCCTAAACTAATGTA: GTCCCCTAAACTAATGTAC
CAACCGCGTCATCACGTCC: AACCGCGTCATCACGTCCA
CTCCGCCCACATAGAAGCA: TCCGCCCACATAGAAGCAA
ACACCATATCTAGACTAAG: CACCATATCTAGACTAAGG
CACTGGGGTAGTTCCAATG: ACTGGGGTAGTTCCAATGC
ACTTTGATTGGAACGTCTT: CTTTGATTGGAACGTCTTT
CTAGACTAAGGGCATGTAA: TAGACTAAGGGCATGTAAC
TTCAGAGGGGATTCGGCAC: TCAGAGGGGATTCGGCACC
AGCCTGATCTGATCACACA: GCCTGATCTGATCACACAT
AACATCGAATTAGTCCTCG: ACATCGAATTAGTCCTCGT
GCGAGAGTAAGAGGACTGG: CGAGAGTAAGAGGACTGGG
GTAACAGTGCAATATGTGG: TAACAGTGCAATATGTGGC
GCATTTCAGAGGGGATTCG: CATTTCAGAGGGGATTCGG
TGCGGCATGTAAGTACCGA: GCGGCATGTAAGTACCGAT
TCATTCGACATAATGTGTT: CATTCGACATAATGTGTTT
ATGTAAGTACCGATTTCTA: TGTAAGTACCGATTTCTAG
GTGAAACCCTTATCAGTAC: TGAAACCCTTATCAGTACT
TAACGATAATGAAAAGGCG: AACGATAATGAAAAGGCGA
TCCAATGTTCCCGATCCTC: CCAATGTTCCCGATCCTCC
TAGACTAAGGGCATGTAAC: AGACTAAGGGCATGTAACC
GTCCTCGTCGGGTTACAGC: TCCTCGTCGGGTTACAGCA
AATGCCAATAAGCCGTCTT: ATGCCAATAAGCCGTCTTG
TGAAAAGGCGATGCGCTAT: GAAAAGGCGATGCGCTATA
GATAATGAAAAGGCGATGC: ATAATGAAAAGGCGATGCG
GAGCACGACGGTGAACCTG: AGCACGACGGTGAACCTGT
ACGTGCTAGGGAGGTAAAG: CGTGCTAGGGAGGTAAAGG
TAATGTGTTTAACGATAAT: AATGTGTTTAACGATAATG
ATGCACGAGGGCTTGTAAC: TGCACGAGGGCTTGTAACA
AAGATTTCCTTCTGAAAGT: AGATTTCCTTCTGAAAGTG
GTGTTGATGCACGAGGGCT: TGTTGATGCACGAGGGCTT
ATCTAGACTAAGGGCATGT: TCTAGACTAAGGGCATGTA
CCGATCCTCCTCGCAGGCT: CGATCCTCCTCGCAGGCTG
GGTTCGATGCCCACCCGGG: GTTCGATGCCCACCCGGGC
CTTGCAAGGGCCCACCCTT: TTGCAAGGGCCCACCCTTA
GCATGCAACCCAGACACTC: CATGCAACCCAGACACTCC
GCTGCGTAGCTCTGAGCGT: CTGCGTAGCTCTGAGCGTT
CTATTCCTAAATGCCAATA: TATTCCTAAATGCCAATAA
CAGTGGTGAATGTCACCTT: AGTGGTGAATGTCACCTTG
CACGTCCACGTTCGGTTCG: ACGTCCACGTTCGGTTCGA
CAACACCCTCCGCCCACAT: AACACCCTCCGCCCACATA
ATCGTGTTGTTAAAACCTT: TCGTGTTGTTAAAACCTTC
ACATTACAATAGCGAGAGT: CATTACAATAGCGAGAGTA
ATGGGGCCGCCTCCCACCG: TGGGGCCGCCTCCCACCGA
ATTTAACGGATTCTGTCCT: TTTAACGGATTCTGTCCTA
TCTATAGGTGGCGAGACAA: CTATAGGTGGCGAGACAAC
GAGAGTAAGAGGACTGGGG: AGAGTAAGAGGACTGGGGT
AGCACGTGTTGCAGTCTAA: GCACGTGTTGCAGTCTAAC
GAAGATTTCCTTCTGAAAG: AAGATTTCCTTCTGAAAGT
GTGACTAACTAATCGAAAA: TGACTAACTAATCGAAAAA
CGCACAGCATGTTGCTTGT: GCACAGCATGTTGCTTGTG
TATATAAAAACGTGCTAGG: ATATAAAAACGTGCTAGGG
TGCCAATAAGCCGTCTTGC: GCCAATAAGCCGTCTTGCA
ATACAGTAGGAAATTTCGG: TACAGTAGGAAATTTCGGT
GTAGGAATGCCAAGCCCCA: TAGGAATGCCAAGCCCCAC
AAAGCCACCCAGCTGCGTG: AAGCCACCCAGCTGCGTGT
TCAGTACCGGAATAGAAGC: CAGTACCGGAATAGAAGCT
CATAATGTGTTTAACGATA: ATAATGTGTTTAACGATAA
TACGACGTCTTGCAAGGGC: ACGACGTCTTGCAAGGGCC
TTGTTATTTGCTACAGCCG: TGTTATTTGCTACAGCCGC
AGTTCCAATGAGGGCCCCG: GTTCCAATGAGGGCCCCGC
CGCTTAGACTCGCTTGCAT: GCTTAGACTCGCTTGCATG
CCGTATGACTCGAGATGAC: CGTATGACTCGAGATGACA
TTGCTTTCATGGACAGGCC: TGCTTTCATGGACAGGCCT
GGCCCCGCACCTCGCAGGC: GCCCCGCACCTCGCAGGCT
ATCTTGCTTTCATGGACAG: TCTTGCTTTCATGGACAGG
CAATCCTATTCCTAAATGC: AATCCTATTCCTAAATGCC
CCAAAACCCAGACAACTGT: CAAAACCCAGACAACTGTG
GAGAGGGGGTAGTCCTGAG: AGAGGGGGTAGTCCTGAGG
TGAAGCACGTGTTGCAGTC: GAAGCACGTGTTGCAGTCT
AAGTGGCAACCATACTGGG: AGTGGCAACCATACTGGGG
TACTGTCGCATGGGGCCGC: ACTGTCGCATGGGGCCGCC
CTAACTAATCGAAAAACAG: TAACTAATCGAAAAACAGG
TCGCGACGGCTCAGTACCG: CGCGACGGCTCAGTACCGG
GTGGTGAATGTCACCTTGT: TGGTGAATGTCACCTTGTT
TATGTGGCGATAAGGAGAC: ATGTGGCGATAAGGAGACC
GAGGGCTTGTAACAGTGCA: AGGGCTTGTAACAGTGCAA
AGGGAGGTAAAGGTCGCAC: GGGAGGTAAAGGTCGCACT
TGAAGATGGGGATCGTGTT: GAAGATGGGGATCGTGTTG
CCGGGCTGATCTTACACTT: CGGGCTGATCTTACACTTC
AAGGCGATGCGCTATACCA: AGGCGATGCGCTATACCAT
GAGTTGAACGTCTTACACC: AGTTGAACGTCTTACACCC
TAATGAAAAGGCGATGCGC: AATGAAAAGGCGATGCGCT
ATGTCCAGTGTCAACTGGG: TGTCCAGTGTCAACTGGGG
AAATACGACGTCTTGCAAG: AATACGACGTCTTGCAAGG
TAGACTTGAAAAGTTGAAG: AGACTTGAAAAGTTGAAGC
TGCTTTCATGGACAGGCCT: GCTTTCATGGACAGGCCTA
TGGATTGCGAAGTGGCAAC: GGATTGCGAAGTGGCAACC
ATCGAAAACTTGCGCCCAA: TCGAAAACTTGCGCCCAAA
TTCCTAAATGCCAATAAGC: TCCTAAATGCCAATAAGCC
TTGGTTGACCGAGATTCCG: TGGTTGACCGAGATTCCGG
GAGGCTGACGGATTCGAAA: AGGCTGACGGATTCGAAAT
CTCGCTTGCATGCAACCCA: TCGCTTGCATGCAACCCAG
GGTCGAAAAACGATGAGGG: GTCGAAAAACGATGAGGGG
GCATGTAAGTACCGATTTC: CATGTAAGTACCGATTTCT
TGTTTGTATTGCCTCCTTT: GTTTGTATTGCCTCCTTTA
CGTTCCCGACGGATGCATT: GTTCCCGACGGATGCATTT
GCGTGGCTCTTGTGAATAC: CGTGGCTCTTGTGAATACA
TATCAATGGTGGCTTCTGA: ATCAATGGTGGCTTCTGAT
CGGCAACACCCTCCGCCCA: GGCAACACCCTCCGCCCAC
CTCGCCGCGCTTTGATTTC: TCGCCGCGCTTTGATTTCC
CAACCCAGACACTCCGATC: AACCCAGACACTCCGATCT
CACATAGAAGCAAAGCCTG: ACATAGAAGCAAAGCCTGA
GTGCCGTATGGTGAAACCC: TGCCGTATGGTGAAACCCT
CTTAAATAAGTTGTCGCTT: TTAAATAAGTTGTCGCTTG
ACTTCACTACAGTATTTTC: CTTCACTACAGTATTTTCG
ATGCGCTATACCATCGTTC: TGCGCTATACCATCGTTCA
TGGTGAAACCCTTATCAGT: GGTGAAACCCTTATCAGTA
CAACATTTATCAGCTCGCG: AACATTTATCAGCTCGCGA
ATAAGTTGTCGCTTGCCTG: TAAGTTGTCGCTTGCCTGT
ACCTTGTCCATTCATATAG: CCTTGTCCATTCATATAGC
CGTATGACTCGAGATGACA: GTATGACTCGAGATGACAG
GGTACTGGGCATAGGTTTA: GTACTGGGCATAGGTTTAA
CACAAGGAAACACAGAGAT: ACAAGGAAACACAGAGATC
AACTTTAGCAACATTTAAC: ACTTTAGCAACATTTAACA
ATGTCACCTTGTTCAATGA: TGTCACCTTGTTCAATGAG
TTCGACATAATGTGTTTAA: TCGACATAATGTGTTTAAC
AGTACCGGAATAGAAGCTT: GTACCGGAATAGAAGCTTA
TCGGTTGCCTGACTGTCGT: CGGTTGCCTGACTGTCGTC
CAATGAGATTTAACGGATT: AATGAGATTTAACGGATTC
TCGTTCACCTTGTCCATTC: CGTTCACCTTGTCCATTCA
ATGGACAGGCCTATAAAGC: TGGACAGGCCTATAAAGCC
CACCTTGTCCATTCATATA: ACCTTGTCCATTCATATAG
GGGCTGATCTTACACTTCA: GGCTGATCTTACACTTCAC
CGTGTTGTAGGTCGAAAAC: GTGTTGTAGGTCGAAAACA
CAATGGTGGCTTCTGATCG: AATGGTGGCTTCTGATCGA
CGATAATGAAAAGGCGATG: GATAATGAAAAGGCGATGC
GGGTCGAAAAACGATGAGG: GGTCGAAAAACGATGAGGG
TGAGCGTTACGACGTGTTT: GAGCGTTACGACGTGTTTG
TTGTCGCTTGCCTGTCTGT: TGTCGCTTGCCTGTCTGTC
TCGAAAAACAGGTACAGAA: CGAAAAACAGGTACAGAAT
ACGGTTTATCATTTCGAAC: CGGTTTATCATTTCGAACG
CGGGTTACAGCACCCGCTC: GGGTTACAGCACCCGCTCT
GGCATGTAACCTTTCGGCT: GCATGTAACCTTTCGGCTA
TCTGATCACACATTAGACT: CTGATCACACATTAGACTT
TTGAAGCACGTGTTGCAGT: TGAAGCACGTGTTGCAGTC
CGACGGCTCAGTACCGGAA: GACGGCTCAGTACCGGAAT
TTATCAATGGTGGCTTCTG: TATCAATGGTGGCTTCTGA
CTGAATCCAGACTGATTCG: TGAATCCAGACTGATTCGC
GCAACCCAGACACTCCGAT: CAACCCAGACACTCCGATC
TTTCCAGCCGCACAGCATG: TTCCAGCCGCACAGCATGT
TGCCTGTCTGTCGTTGCGT: GCCTGTCTGTCGTTGCGTG
AATGAAAAGGCGATGCGCT: ATGAAAAGGCGATGCGCTA
GTCGCACTTTGATTGGAAC: TCGCACTTTGATTGGAACG
ACCTCGCAGGCTGGGCAAC: CCTCGCAGGCTGGGCAACA
ACCTTGTTCAATGAGATTT: CCTTGTTCAATGAGATTTA
TCACACATTAGACTTGAAA: CACACATTAGACTTGAAAA
CATACTGGGGTAGTTCCAA: ATACTGGGGTAGTTCCAAT
CTACAGCCGCGTTATATAA: TACAGCCGCGTTATATAAA
CGTTGCGTGGCTCTTGTGA: GTTGCGTGGCTCTTGTGAA
CTCGTCGGGTTACAGCACC: TCGTCGGGTTACAGCACCC
AGGCTGGGCAACAAGTTCT: GGCTGGGCAACAAGTTCTC
TCTTTGAAGAGTCCCGCCG: CTTTGAAGAGTCCCGCCGG
CCTCCGCCCACATAGAAGC: CTCCGCCCACATAGAAGCA
AGTCACAAGGAAACACAGA: GTCACAAGGAAACACAGAG
ACACTCCGATCTCGCCGCG: CACTCCGATCTCGCCGCGC
AAGGTCGCACTTTGATTGG: AGGTCGCACTTTGATTGGA
CTTATCAGTACTGTCGCAT: TTATCAGTACTGTCGCATG
CCCGAGGAATTTGGTTGAC: CCGAGGAATTTGGTTGACC
GACTCGAGATGACAGAGGC: ACTCGAGATGACAGAGGCT
TCGGCACCAACATTCTGCG: CGGCACCAACATTCTGCGA
TGATCACACATTAGACTTG: GATCACACATTAGACTTGA
TCCTCATTCGACATAATGT: CCTCATTCGACATAATGTG
TCTGAGCGTTACGACGTGT: CTGAGCGTTACGACGTGTT
GCTAGGTTTCAGTGGTGAA: CTAGGTTTCAGTGGTGAAT
CGGTTCGATGCCCACCCGG: GGTTCGATGCCCACCCGGG
CAGCCTCGGTTTCCAGCCG: AGCCTCGGTTTCCAGCCGC
GATCTGATCACACATTAGA: ATCTGATCACACATTAGAC
TCTCTTAAATAAGTTGTCG: CTCTTAAATAAGTTGTCGC
GTGCGATCACTGTTGTTAT: TGCGATCACTGTTGTTATT
TGCATTTCAGAGGGGATTC: GCATTTCAGAGGGGATTCG
GAAAACTTGCGCCCAAAAG: AAAACTTGCGCCCAAAAGC
AAGTTGTCGCTTGCCTGTC: AGTTGTCGCTTGCCTGTCT
TCCCGATCCTCCTCGCAGG: CCCGATCCTCCTCGCAGGC
GTGGTACTTGTTCAACCGC: TGGTACTTGTTCAACCGCG
TGCCGTGGTACTTGTTCAA: GCCGTGGTACTTGTTCAAC
TAGCTACTCCTGTTTGTAT: AGCTACTCCTGTTTGTATT
AAGTTGAAGCACGTGTTGC: AGTTGAAGCACGTGTTGCA
TCTTCCCTCGCAGGCTGGG: CTTCCCTCGCAGGCTGGGC
ACACCCAAGATACATTACA: CACCCAAGATACATTACAA
TTGCGTGGCTCTTGTGAAT: TGCGTGGCTCTTGTGAATA
ATGCGAGGGTCTTCCCTCG: TGCGAGGGTCTTCCCTCGC
AGTCTGCCGTGGTACTTGT: GTCTGCCGTGGTACTTGTT
AAAACCTTCCCCGAGGAAT: AAACCTTCCCCGAGGAATT
CACCTCGCAGGCTGGGCAA: ACCTCGCAGGCTGGGCAAC
GGCTGGGCAACATTTATCA: GCTGGGCAACATTTATCAG
CGCGGTCATGAAGATTTCC: GCGGTCATGAAGATTTCCT
TTCCCGAATCTGCCATGTC: TCCCGAATCTGCCATGTCC
GACTTGAAAAGTTGAAGCA: ACTTGAAAAGTTGAAGCAC
TTTTTGCGCAGTTATCAAT: TTTTGCGCAGTTATCAATG
CCAATGCGAGGGTCTTCCC: CAATGCGAGGGTCTTCCCT
GATGCCCACCCGGGCTGAT: ATGCCCACCCGGGCTGATC
GGTGACTAACTAATCGAAA: GTGACTAACTAATCGAAAA
TCTTGCACTTATACGTGGA: CTTGCACTTATACGTGGAT
TTCAATGAGATTTAACGGA: TCAATGAGATTTAACGGAT
ACTGGGGTAGTTCCAATGC: CTGGGGTAGTTCCAATGCG
CTTAGACTCGCTTGCATGC: TTAGACTCGCTTGCATGCA
CCTGAATCCAGACTGATTC: CTGAATCCAGACTGATTCG
TGAGATTTAACGGATTCTG: GAGATTTAACGGATTCTGT
TTTCAGAGGGGATTCGGCA: TTCAGAGGGGATTCGGCAC
CTGATCTGATCACACATTA: TGATCTGATCACACATTAG
ATTCAACTTTAGCAACATT: TTCAACTTTAGCAACATTT
TCCAATGGAATAACATCGC: CCAATGGAATAACATCGCC
GCATGTAACCTTTCGGCTA: CATGTAACCTTTCGGCTAG
CCTAAAACCAATCAACATC: CTAAAACCAATCAACATCG
TTAAAACCTTCCCCGAGGA: TAAAACCTTCCCCGAGGAA
ATGAGATTTAACGGATTCT: TGAGATTTAACGGATTCTG
TGTAAGTACCGATTTCTAG: GTAAGTACCGATTTCTAGC
GTATGGTGAAACCCTTATC: TATGGTGAAACCCTTATCA
AGGCTGGGCAACATTTATC: GGCTGGGCAACATTTATCA
ACCCAGCTGCGTGTTGATG: CCCAGCTGCGTGTTGATGC
GCCTCCCACCGAATCCCTC: CCTCCCACCGAATCCCTCG
CGAGACTCGAATAGCCTGA: GAGACTCGAATAGCCTGAA
TCGCCTCGCAGGCTGGGCA: CGCCTCGCAGGCTGGGCAA
CAGAGATCACTACATAGGC: AGAGATCACTACATAGGCG
AGCGTTACGACGTGTTTGC: GCGTTACGACGTGTTTGCA
ATTCAGGGACACTGGGGTA: TTCAGGGACACTGGGGTAG
AACGAGACTCGAATAGCCT: ACGAGACTCGAATAGCCTG
AAGCAAAGCCTGATCTGAT: AGCAAAGCCTGATCTGATC
ATTCCTAGGGGTGACTAAC: TTCCTAGGGGTGACTAACT
CCCACCGAATCCCTCGATC: CCACCGAATCCCTCGATCC
GCCCAGGTATCGAAAACTT: CCCAGGTATCGAAAACTTG
CTCGAATAGCCTGAATCCA: TCGAATAGCCTGAATCCAG
GTTTGTATTGCCTCCTTTA: TTTGTATTGCCTCCTTTAA
TCGCAGGCTGGGCAACAGT: CGCAGGCTGGGCAACAGTT
CCCAGGTATCGAAAACTTG: CCAGGTATCGAAAACTTGC
CTAAACTAATGTACAAACC: TAAACTAATGTACAAACCT
AAAAACGTGCTAGGGAGGT: AAAACGTGCTAGGGAGGTA
CAGCTGCGTGTTGATGCAC: AGCTGCGTGTTGATGCACG
GGAATAGAAGCTTAACGCG: GAATAGAAGCTTAACGCGT
CATTCCTAGGGGTGACTAA: ATTCCTAGGGGTGACTAAC
GCTCACTCTTTGAAGAGTC: CTCACTCTTTGAAGAGTCC
ACCGCGTCATCACGTCCAC: CCGCGTCATCACGTCCACG
CACCAAGGGAGTTGGGTCG: ACCAAGGGAGTTGGGTCGA
GAGTGCGATCACTGTTGTT: AGTGCGATCACTGTTGTTA
TTATCATTTCGAACGAGAC: TATCATTTCGAACGAGACT
CACACATTAGACTTGAAAA: ACACATTAGACTTGAAAAG
ATGTAACCTTTCGGCTAGA: TGTAACCTTTCGGCTAGAC
ACAACGCACATTCCTAGGG: CAACGCACATTCCTAGGGG
AAAGCCTGATCTGATCACA: AAGCCTGATCTGATCACAC
CACCCGCTCTTGCCTCCTC: ACCCGCTCTTGCCTCCTCA
ACTAACTAATCGAAAAACA: CTAACTAATCGAAAAACAG
TAGGCGTGCTCGTTTGCGG: AGGCGTGCTCGTTTGCGGC
TCAACATCGAATTAGTCCT: CAACATCGAATTAGTCCTC
GGGAGTTGGGTCGAAAAAC: GGAGTTGGGTCGAAAAACG
ACAGCATGTTGCTTGTGTC: CAGCATGTTGCTTGTGTCC
TTCGATTACAACGTCCCGC: TCGATTACAACGTCCCGCC
CACGACGGTGAACCTGTCA: ACGACGGTGAACCTGTCAT
GTAGTCCTGAGGACACAGC: TAGTCCTGAGGACACAGCC
CTGTCCTAGCGGAGCTCAA: TGTCCTAGCGGAGCTCAAA
GGGGTAGTTCCAATGCGAG: GGGTAGTTCCAATGCGAGG
GTCCGGGAGAGGTGCCGTA: TCCGGGAGAGGTGCCGTAT
AGGACTGGGGTAGTTCCAA: GGACTGGGGTAGTTCCAAT
TTACGACGTGTTTGCAATG: TACGACGTGTTTGCAATGA
GAAGGCTGCGTAGCTCTGA: AAGGCTGCGTAGCTCTGAG
GGTAGTTCCAATGCGAGGG: GTAGTTCCAATGCGAGGGT
AGAGGGGATTCGGCACCAA: GAGGGGATTCGGCACCAAC
TGTAACCTTTCGGCTAGAC: GTAACCTTTCGGCTAGACG
TGCACGAGGGCTTGTAACA: GCACGAGGGCTTGTAACAG
GATCACTACATAGGCGTGC: ATCACTACATAGGCGTGCT
TTCCAATGGAATAACATCG: TCCAATGGAATAACATCGC
ATATTCAGGGACACTGGGG: TATTCAGGGACACTGGGGT
CTGGGCTGAAGAAGGCTGC: TGGGCTGAAGAAGGCTGCG
GCGTTATATAAAAACGTGC: CGTTATATAAAAACGTGCT
TGACGGATTCGAAATACGA: GACGGATTCGAAATACGAC
ATCCAGGCAGTCACAAGGA: TCCAGGCAGTCACAAGGAA
AGTTCCAATGGAATAACAT: GTTCCAATGGAATAACATC
ATATTTTTGCGCAGTTATC: TATTTTTGCGCAGTTATCA
AGCCGTCTTGCACTTATAC: GCCGTCTTGCACTTATACG
GCAGTCTAACCCTAAAACC: CAGTCTAACCCTAAAACCA
TATAGCTAGGTTTCAGTGG: ATAGCTAGGTTTCAGTGGT
ACCACCAAGGGAGTTGGGT: CCACCAAGGGAGTTGGGTC
ACAGAATTTAGCTACTCCT: CAGAATTTAGCTACTCCTG
ATCTGATCACACATTAGAC: TCTGATCACACATTAGACT
TCCTAAATGCCAATAAGCC: CCTAAATGCCAATAAGCCG
GGGAGGTAAAGGTCGCACT: GGAGGTAAAGGTCGCACTT
TGTTATTTGCTACAGCCGC: GTTATTTGCTACAGCCGCG
TTCCCCGAGGAATTTGGTT: TCCCCGAGGAATTTGGTTG
GCGTGCTCGTTTGCGGCAT: CGTGCTCGTTTGCGGCATG
AGGGGTGACTAACTAATCG: GGGGTGACTAACTAATCGA
GATTACAACGTCCCGCCGT: ATTACAACGTCCCGCCGTA
GAGGGGCGCTTAGACTCGC: AGGGGCGCTTAGACTCGCT
GACTCGCTTGCATGCAACC: ACTCGCTTGCATGCAACCC
ATTGCGAAGTGGCAACCAT: TTGCGAAGTGGCAACCATA
AGCATGTTGCTTGTGTCCG: GCATGTTGCTTGTGTCCGG
GCCCACCCGGGCTGATCTT: CCCACCCGGGCTGATCTTA
AGTACCGATTTCTAGCGAG: GTACCGATTTCTAGCGAGC
GCACGACGGTGAACCTGTC: CACGACGGTGAACCTGTCA
CCGAGGAATTTGGTTGACC: CGAGGAATTTGGTTGACCG
GGTAGTTCCAATGTTCCCG: GTAGTTCCAATGTTCCCGA
TGCAACCCAGACACTCCGA: GCAACCCAGACACTCCGAT
ATTTTCGTTCATGAGTTCG: TTTTCGTTCATGAGTTCGA
CTTAACGCGTTCCCGACGG: TTAACGCGTTCCCGACGGA
AGACTTGAAAAGTTGAAGC: GACTTGAAAAGTTGAAGCA
TTTCATGGACAGGCCTATA: TTCATGGACAGGCCTATAA
CCTATAAAGCCACCCAGCT: CTATAAAGCCACCCAGCTG
GTTCAACCGCGTCATCACG: TTCAACCGCGTCATCACGT
ACGAGACTCGAATAGCCTG: CGAGACTCGAATAGCCTGA
ACGTCTTGCAAGGGCCCAC: CGTCTTGCAAGGGCCCACC
CGCCCACATAGAAGCAAAG: GCCCACATAGAAGCAAAGC
AATGTGTTTAACGATAATG: ATGTGTTTAACGATAATGA
TGCGTAGCTCTGAGCGTTA: GCGTAGCTCTGAGCGTTAC
GCCCCACACCATATCTAGA: CCCCACACCATATCTAGAC
TGATGCACGAGGGCTTGTA: GATGCACGAGGGCTTGTAA
GCAGGCTGGGCAACATTTA: CAGGCTGGGCAACATTTAT
ACACCCTCCGCCCACATAG: CACCCTCCGCCCACATAGA
ATATGTGGCGATAAGGAGA: TATGTGGCGATAAGGAGAC
GTCCACGTTCGGTTCGATG: TCCACGTTCGGTTCGATGC
GAGACTCGAATAGCCTGAA: AGACTCGAATAGCCTGAAT
TAGTTCCAATGCGAGGGTC: AGTTCCAATGCGAGGGTCT
GTGCTCGTTTGCGGCATGT: TGCTCGTTTGCGGCATGTA
AACTTGCGCCCAAAAGCTA: ACTTGCGCCCAAAAGCTAG
GGCTTGTAACAGTGCAATA: GCTTGTAACAGTGCAATAT
CGATTACAACGTCCCGCCG: GATTACAACGTCCCGCCGT
GATGACAGAGGCTGACGGA: ATGACAGAGGCTGACGGAT
AGCATCTCGTGGCCCAGGT: GCATCTCGTGGCCCAGGTA
CAGACTGATTCGCGGTCAT: AGACTGATTCGCGGTCATG
TTTCAGTGGTGAATGTCAC: TTCAGTGGTGAATGTCACC
ACCGGAATAGAAGCTTAAC: CCGGAATAGAAGCTTAACG
TGTTTAACGATAATGAAAA: GTTTAACGATAATGAAAAG
CGATGCCCACCCGGGCTGA: GATGCCCACCCGGGCTGAT
GGCTGACGGATTCGAAATA: GCTGACGGATTCGAAATAC
GTCAGCCTCGGTTTCCAGC: TCAGCCTCGGTTTCCAGCC
GTTGACCGAGATTCCGGGT: TTGACCGAGATTCCGGGTC
CATGAAGATTTCCTTCTGA: ATGAAGATTTCCTTCTGAA
CCAGCCGCACAGCATGTTG: CAGCCGCACAGCATGTTGC
TTACAATAGCGAGAGTAAG: TACAATAGCGAGAGTAAGA
GAGGTGCCGTATGGTGAAA: AGGTGCCGTATGGTGAAAC
GATCTCGCCGCGCTTTGAT: ATCTCGCCGCGCTTTGATT
CTAAATGCCAATAAGCCGT: TAAATGCCAATAAGCCGTC
TACGTGGATTGCGAAGTGG: ACGTGGATTGCGAAGTGGC
CCGACGGATGCATTTCAGA: CGACGGATGCATTTCAGAG
CACTTTGATTGGAACGTCT: ACTTTGATTGGAACGTCTT
TTGCGGCATGTAAGTACCG: TGCGGCATGTAAGTACCGA
TTTGTATTGCCTCCTTTAA: TTGTATTGCCTCCTTTAAG
TCCTCGTCGGGTTACAGCA: CCTCGTCGGGTTACAGCAC
CCCACACCATATCTAGACT: CCACACCATATCTAGACTA
CAGACAACTGTGAGTTGAA: AGACAACTGTGAGTTGAAC
AAGCAGTCTGCCGTGGTAC: AGCAGTCTGCCGTGGTACT
GAAGTGGCAACCATACTGG: AAGTGGCAACCATACTGGG
CAGTACCGGAATAGAAGCT: AGTACCGGAATAGAAGCTT
CAGCCTGGGAGGTGATGAA: AGCCTGGGAGGTGATGAAT
GCAGGCTGGGCAACAAGTT: CAGGCTGGGCAACAAGTTC
CCCCGAGGAATTTGGTTGA: CCCGAGGAATTTGGTTGAC
TGATCGAGTGCGATCACTG: GATCGAGTGCGATCACTGT
TTGCACTTATACGTGGATT: TGCACTTATACGTGGATTG
ACTGGGGTAGTTCCAATGG: CTGGGGTAGTTCCAATGGA
ATAGCCTGAATCCAGACTG: TAGCCTGAATCCAGACTGA
GATCTTACACTTCACTACA: ATCTTACACTTCACTACAG
TAGTCCTCGTCGGGTTACA: AGTCCTCGTCGGGTTACAG
GGCACCAACATTCTGCGAA: GCACCAACATTCTGCGAAG
AATAGAAGCTTAACGCGTT: ATAGAAGCTTAACGCGTTC
AAGCCACCCAGCTGCGTGT: AGCCACCCAGCTGCGTGTT
CAATGTTCCCGATCCTCCT: AATGTTCCCGATCCTCCTC
AATGGTGGCTTCTGATCGA: ATGGTGGCTTCTGATCGAG
TAGGGCTGGGCTGAAGAAG: AGGGCTGGGCTGAAGAAGG
ACGTCCACGTTCGGTTCGA: CGTCCACGTTCGGTTCGAT
TGGAACGTCTTTTGTATCA: GGAACGTCTTTTGTATCAG
TTCGATGCCCACCCGGGCT: TCGATGCCCACCCGGGCTG
TGGCCCAGGTATCGAAAAC: GGCCCAGGTATCGAAAACT
AATTTAGCTACTCCTGTTT: ATTTAGCTACTCCTGTTTG
GCTTGTGTCCGGGAGAGGT: CTTGTGTCCGGGAGAGGTG
TCGTTTGCGGCATGTAAGT: CGTTTGCGGCATGTAAGTA
CTTCACTACAGTATTTTCG: TTCACTACAGTATTTTCGT
GTACAGAATTTAGCTACTC: TACAGAATTTAGCTACTCC
GGTAGTTCCAATGGAATAA: GTAGTTCCAATGGAATAAC
GTTTGCGGCATGTAAGTAC: TTTGCGGCATGTAAGTACC
ACTGTCGTCCCCTAAACTA: CTGTCGTCCCCTAAACTAA
TCGCTTGCCTGTCTGTCGT: CGCTTGCCTGTCTGTCGTT
GCCCAAAACCCAGACAACT: CCCAAAACCCAGACAACTG
AGACCACCAAGGGAGTTGG: GACCACCAAGGGAGTTGGG
TCAGAGGGGATTCGGCACC: CAGAGGGGATTCGGCACCA
CATGAGTTCGATTACAACG: ATGAGTTCGATTACAACGT
TGCCTCCTCATTCGACATA: GCCTCCTCATTCGACATAA
GCGTTACGACGTGTTTGCA: CGTTACGACGTGTTTGCAA
AATAAGCCGTCTTGCACTT: ATAAGCCGTCTTGCACTTA
GTCTAACCCTAAAACCAAT: TCTAACCCTAAAACCAATC
ACCCAAGATACATTACAAT: CCCAAGATACATTACAATA
GGGGGTAGTCCTGAGGACA: GGGGTAGTCCTGAGGACAC
TCAACTTTAGCAACATTTA: CAACTTTAGCAACATTTAA
GTCCTGAGGACACAGCCTG: TCCTGAGGACACAGCCTGG
GCGTGTTGATGCACGAGGG: CGTGTTGATGCACGAGGGC
CAGAGGGGATTCGGCACCA: AGAGGGGATTCGGCACCAA
CTCGCAGGCTGGGCAACAG: TCGCAGGCTGGGCAACAGT
CTTGCCTCCTCATTCGACA: TTGCCTCCTCATTCGACAT
CACTGTTGTTATTTGCTAC: ACTGTTGTTATTTGCTACA
TGGGGCCGCCTCCCACCGA: GGGGCCGCCTCCCACCGAA
TAACCTTTCGGCTAGACGG: AACCTTTCGGCTAGACGGT
CTGTTTTAACACGTGTTGT: TGTTTTAACACGTGTTGTA
ATTGGAACGTCTTTTGTAT: TTGGAACGTCTTTTGTATC
GTCTTCCCTCGCAGGCTGG: TCTTCCCTCGCAGGCTGGG
CTCTTGCCTCCTCATTCGA: TCTTGCCTCCTCATTCGAC
CCACCAAGGGAGTTGGGTC: CACCAAGGGAGTTGGGTCG
TAACCCTAAAACCAATCAA: AACCCTAAAACCAATCAAC
ACTTATACGTGGATTGCGA: CTTATACGTGGATTGCGAA
ATATGGTACTGGGCATAGG: TATGGTACTGGGCATAGGT
TGTCAACTGGGGTAGTTCC: GTCAACTGGGGTAGTTCCA
CATTTCGAACGAGACTCGA: ATTTCGAACGAGACTCGAA
TTGCGCAGTTATCAATGGT: TGCGCAGTTATCAATGGTG
TGCGTGGCTCTTGTGAATA: GCGTGGCTCTTGTGAATAC
AAGTGGAAGGCTACGCGTC: AGTGGAAGGCTACGCGTCG
TTAGTCCTCGTCGGGTTAC: TAGTCCTCGTCGGGTTACA
TGAGTTCGATTACAACGTC: GAGTTCGATTACAACGTCC
AGGTACAGAATTTAGCTAC: GGTACAGAATTTAGCTACT
CGACGGTGAACCTGTCATA: GACGGTGAACCTGTCATAT
GCTAGACGGTTTATCATTT: CTAGACGGTTTATCATTTC
CTAGCGGAGCTCAAAAAGT: TAGCGGAGCTCAAAAAGTC
TTGTATCAGTGTCACAGAC: TGTATCAGTGTCACAGACC
CGAAGTGGCAACCATACTG: GAAGTGGCAACCATACTGG
GTTTCAGTGGTGAATGTCA: TTTCAGTGGTGAATGTCAC
GGGCATGTAACCTTTCGGC: GGCATGTAACCTTTCGGCT
GTTATCAATGGTGGCTTCT: TTATCAATGGTGGCTTCTG
GGGCAACATTTATCAGCTC: GGCAACATTTATCAGCTCG
CAGTTATCAATGGTGGCTT: AGTTATCAATGGTGGCTTC
GATTTAACGGATTCTGTCC: ATTTAACGGATTCTGTCCT
TATAGGTGGCGAGACAACG: ATAGGTGGCGAGACAACGC
AATGAGATTTAACGGATTC: ATGAGATTTAACGGATTCT
TTCTGCGAAGCAATCCAAG: TCTGCGAAGCAATCCAAGC
TAACAGTGCAATATGTGGC: AACAGTGCAATATGTGGCG
ACTGGGGTAGTTCCAATGA: CTGGGGTAGTTCCAATGAG
TGCGTGTTGATGCACGAGG: GCGTGTTGATGCACGAGGG
TTCGGAATTCAACTTTAGC: TCGGAATTCAACTTTAGCA
GCCTCGCAGGCTGGGCAAC: CCTCGCAGGCTGGGCAACA
GTTTCCTTCGGAATTCAAC: TTTCCTTCGGAATTCAACT
ACCAATCAACATCGAATTA: CCAATCAACATCGAATTAG
GCATAGGTTTAAATCTTGC: CATAGGTTTAAATCTTGCT
AGACGGTTTATCATTTCGA: GACGGTTTATCATTTCGAA
AGGGCTTGTAACAGTGCAA: GGGCTTGTAACAGTGCAAT
CGGATTCGAAATACGACGT: GGATTCGAAATACGACGTC
GCTCAGTACCGGAATAGAA: CTCAGTACCGGAATAGAAG
GGGGATCGTGTTGTTAAAA: GGGATCGTGTTGTTAAAAC
GTATTTTCGTTCATGAGTT: TATTTTCGTTCATGAGTTC
GGATTCGGCACCAACATTC: GATTCGGCACCAACATTCT
CTGGGCAACAAGTTCTCTT: TGGGCAACAAGTTCTCTTA
TGAACCTGTCATATGGTAC: GAACCTGTCATATGGTACT
TCCCGCCGTATGACTCGAG: CCCGCCGTATGACTCGAGA
GGATGCATTTCAGAGGGGA: GATGCATTTCAGAGGGGAT
TGATTCGCGGTCATGAAGA: GATTCGCGGTCATGAAGAT
GTGGAAGGCTACGCGTCGG: TGGAAGGCTACGCGTCGGG
GGTGAATGTCACCTTGTTC: GTGAATGTCACCTTGTTCA
AACATTTATCAGCTCGCGA: ACATTTATCAGCTCGCGAC
AGCCACCCAGCTGCGTGTT: GCCACCCAGCTGCGTGTTG
TCACGTCCACGTTCGGTTC: CACGTCCACGTTCGGTTCG
TCCCACCGAATCCCTCGAT: CCCACCGAATCCCTCGATC
AATTCAACTTTAGCAACAT: ATTCAACTTTAGCAACATT
GTATCAGTGTCACAGACCA: TATCAGTGTCACAGACCAC
TCATATAGCTAGGTTTCAG: CATATAGCTAGGTTTCAGT
CGTCTTGCAAGGGCCCACC: GTCTTGCAAGGGCCCACCC
CCCAGCTGCGTGTTGATGC: CCAGCTGCGTGTTGATGCA
ATCGAATTAGTCCTCGTCG: TCGAATTAGTCCTCGTCGG
CACAGACCACCAAGGGAGT: ACAGACCACCAAGGGAGTT
GTTGAACGTCTTACACCCA: TTGAACGTCTTACACCCAA
GTTCGATGCCCACCCGGGC: TTCGATGCCCACCCGGGCT
TCACTACATAGGCGTGCTC: CACTACATAGGCGTGCTCG
CGCGTCGGGCTGGCCCAAA: GCGTCGGGCTGGCCCAAAA
TGCTTGTGTCCGGGAGAGG: GCTTGTGTCCGGGAGAGGT
ACTCTTTGAAGAGTCCCGC: CTCTTTGAAGAGTCCCGCC
TGGGGTAGTTCCAATGCGA: GGGGTAGTTCCAATGCGAG
TTGCATGCAACCCAGACAC: TGCATGCAACCCAGACACT
GATTCGAAATACGACGTCT: ATTCGAAATACGACGTCTT
GCTAGAGAGGGGGTAGTCC: CTAGAGAGGGGGTAGTCCT
GTCGAAAAACGATGAGGGG: TCGAAAAACGATGAGGGGC
AGACCGCTTGGTAGGAATG: GACCGCTTGGTAGGAATGC
AGGGACACTGGGGTAGTTC: GGGACACTGGGGTAGTTCC
CAGCACCCGCTCTTGCCTC: AGCACCCGCTCTTGCCTCC
CTAGACGGTTTATCATTTC: TAGACGGTTTATCATTTCG
AAGGGCCCACCCTTAGGGC: AGGGCCCACCCTTAGGGCT
TCGGTTCGATGCCCACCCG: CGGTTCGATGCCCACCCGG
TTCACCTTGTCCATTCATA: TCACCTTGTCCATTCATAT
TCCGGGAGAGGTGCCGTAT: CCGGGAGAGGTGCCGTATG
ATAACATCGCCTCGCAGGC: TAACATCGCCTCGCAGGCT
GCTGGGCAACATTTATCAG: CTGGGCAACATTTATCAGC
TATCAGCTCGCGACGGCTC: ATCAGCTCGCGACGGCTCA
CTCGTGGCCCAGGTATCGA: TCGTGGCCCAGGTATCGAA
CTAAGGGCATGTAACCTTT: TAAGGGCATGTAACCTTTC
TATTTTCGTTCATGAGTTC: ATTTTCGTTCATGAGTTCG
GTCCCGCCGTATGACTCGA: TCCCGCCGTATGACTCGAG
GTTGGGTCGAAAAACGATG: TTGGGTCGAAAAACGATGA
CTCCTTTAAGTGGAAGGCT: TCCTTTAAGTGGAAGGCTA
AGTCTAACCCTAAAACCAA: GTCTAACCCTAAAACCAAT
AGGAATTTGGTTGACCGAG: GGAATTTGGTTGACCGAGA
GTTGCGTGGCTCTTGTGAA: TTGCGTGGCTCTTGTGAAT
CAGGCTGGGCAACAGTTTC: AGGCTGGGCAACAGTTTCC
GCTGACGGATTCGAAATAC: CTGACGGATTCGAAATACG
TCATATTCAGGGACACTGG: CATATTCAGGGACACTGGG
ACTCCTGTTTGTATTGCCT: CTCCTGTTTGTATTGCCTC
CCTAGCGGAGCTCAAAAAG: CTAGCGGAGCTCAAAAAGT
GGGTCATGCTGTTTTAACA: GGTCATGCTGTTTTAACAC
ATCCTCCTCGCAGGCTGGG: TCCTCCTCGCAGGCTGGGC
GGGCAACAGTTTCCTTCGG: GGCAACAGTTTCCTTCGGA
AGATTTCCTTCTGAAAGTG: GATTTCCTTCTGAAAGTGT
CAGAGGCTGACGGATTCGA: AGAGGCTGACGGATTCGAA
CTACAGTATTTTCGTTCAT: TACAGTATTTTCGTTCATG
ACAGACCACCAAGGGAGTT: CAGACCACCAAGGGAGTTG
TGTCGCATGGGGCCGCCTC: GTCGCATGGGGCCGCCTCC
TAAATCTTGCTTTCATGGA: AAATCTTGCTTTCATGGAC
GGGCAACAAGTTCTCTTAA: GGCAACAAGTTCTCTTAAA
GTAAAGGTCGCACTTTGAT: TAAAGGTCGCACTTTGATT
GGAATGCCAAGCCCCACAC: GAATGCCAAGCCCCACACC
GGTCTTCCCTCGCAGGCTG: GTCTTCCCTCGCAGGCTGG
GATTGCGAAGTGGCAACCA: ATTGCGAAGTGGCAACCAT
AGGAATGCCAAGCCCCACA: GGAATGCCAAGCCCCACAC
CGTTTGCGGCATGTAAGTA: GTTTGCGGCATGTAAGTAC
TCTGCCATGTCCAGTGTCA: CTGCCATGTCCAGTGTCAA
CACACCATATCTAGACTAA: ACACCATATCTAGACTAAG
GAAATACGACGTCTTGCAA: AAATACGACGTCTTGCAAG
TACGACGTGTTTGCAATGA: ACGACGTGTTTGCAATGAA
GCACGAGGGCTTGTAACAG: CACGAGGGCTTGTAACAGT
CCCTAAAACCAATCAACAT: CCTAAAACCAATCAACATC
AGTTCTCTTAAATAAGTTG: GTTCTCTTAAATAAGTTGT
TCAGTGGTGAATGTCACCT: CAGTGGTGAATGTCACCTT
CTACTCCTGTTTGTATTGC: TACTCCTGTTTGTATTGCC
ATAGGTTTAAATCTTGCTT: TAGGTTTAAATCTTGCTTT
ATAGGTGGCGAGACAACGC: TAGGTGGCGAGACAACGCA
AGGCTGCGTAGCTCTGAGC: GGCTGCGTAGCTCTGAGCG
AGCAACATTTAACAAGCAT: GCAACATTTAACAAGCATC
CTAATGTACAAACCTCTAT: TAATGTACAAACCTCTATA
GTTATTTGCTACAGCCGCG: TTATTTGCTACAGCCGCGT
CTCGATCCAGGCAGTCACA: TCGATCCAGGCAGTCACAA
TATGGTGAAACCCTTATCA: ATGGTGAAACCCTTATCAG
ATTTCAGAGGGGATTCGGC: TTTCAGAGGGGATTCGGCA
TCCTATTCCTAAATGCCAA: CCTATTCCTAAATGCCAAT
ATTTGGTTGACCGAGATTC: TTTGGTTGACCGAGATTCC
GCGCTATACCATCGTTCAC: CGCTATACCATCGTTCACC
GCCGCACAGCATGTTGCTT: CCGCACAGCATGTTGCTTG
CGTCTTACACCCAAGATAC: GTCTTACACCCAAGATACA
CTTTCGGCTAGACGGTTTA: TTTCGGCTAGACGGTTTAT
CAAGCCCCACACCATATCT: AAGCCCCACACCATATCTA
TTTCCTTCTGAAAGTGTAT: TTCCTTCTGAAAGTGTATA
AACGATGAGGGGCGCTTAG: ACGATGAGGGGCGCTTAGA
ATAGAAGCAAAGCCTGATC: TAGAAGCAAAGCCTGATCT
AAGATACATTACAATAGCG: AGATACATTACAATAGCGA
CGAATCCCTCGATCCAGGC: GAATCCCTCGATCCAGGCA
TGCGAGGGTCTTCCCTCGC: GCGAGGGTCTTCCCTCGCA
AACGCACATTCCTAGGGGT: ACGCACATTCCTAGGGGTG
TTTAGCTACTCCTGTTTGT: TTAGCTACTCCTGTTTGTA
AGTAAGAGGACTGGGGTAG: GTAAGAGGACTGGGGTAGT
TCACCTTGTTCAATGAGAT: CACCTTGTTCAATGAGATT
TGCTGTTTTAACACGTGTT: GCTGTTTTAACACGTGTTG
TAGCTAGGTTTCAGTGGTG: AGCTAGGTTTCAGTGGTGA
CCGCGTTATATAAAAACGT: CGCGTTATATAAAAACGTG
CACCGAATCCCTCGATCCA: ACCGAATCCCTCGATCCAG
AACAAGTTCTCTTAAATAA: ACAAGTTCTCTTAAATAAG
GTGGATTGCGAAGTGGCAA: TGGATTGCGAAGTGGCAAC
ATCGAAAAACAGGTACAGA: TCGAAAAACAGGTACAGAA
TCTTAAATAAGTTGTCGCT: CTTAAATAAGTTGTCGCTT
ACAATAGCGAGAGTAAGAG: CAATAGCGAGAGTAAGAGG
CGTTCACCTTGTCCATTCA: GTTCACCTTGTCCATTCAT
GCCGTATGGTGAAACCCTT: CCGTATGGTGAAACCCTTA
TAAAACCTTCCCCGAGGAA: AAAACCTTCCCCGAGGAAT
CAATCCAAGCAGTCTGCCG: AATCCAAGCAGTCTGCCGT
GATTTCCTTCTGAAAGTGT: ATTTCCTTCTGAAAGTGTA
AAGCCGTCTTGCACTTATA: AGCCGTCTTGCACTTATAC
AATGAGGGCCCCGCACCTC: ATGAGGGCCCCGCACCTCG
AAAGGTCGCACTTTGATTG: AAGGTCGCACTTTGATTGG
TGTGTCCGGGAGAGGTGCC: GTGTCCGGGAGAGGTGCCG
TTGCAGTCTAACCCTAAAA: TGCAGTCTAACCCTAAAAC
CGATGAGGGGCGCTTAGAC: GATGAGGGGCGCTTAGACT
TGGACAGGCCTATAAAGCC: GGACAGGCCTATAAAGCCA
TGCGATCACTGTTGTTATT: GCGATCACTGTTGTTATTT
TGTATCAGTGTCACAGACC: GTATCAGTGTCACAGACCA
GTTTGCAATGAAGATGGGG: TTTGCAATGAAGATGGGGA
ACTGGGCATAGGTTTAAAT: CTGGGCATAGGTTTAAATC
CCGAATCCCTCGATCCAGG: CGAATCCCTCGATCCAGGC
ATTTCTAGCGAGCACGACG: TTTCTAGCGAGCACGACGG
GATTCTGTCCTAGCGGAGC: ATTCTGTCCTAGCGGAGCT
CGCACATTCCTAGGGGTGA: GCACATTCCTAGGGGTGAC
GACTAACTAATCGAAAAAC: ACTAACTAATCGAAAAACA
AATGCGAGGGTCTTCCCTC: ATGCGAGGGTCTTCCCTCG
TGATTGGAACGTCTTTTGT: GATTGGAACGTCTTTTGTA
CACAGCATGTTGCTTGTGT: ACAGCATGTTGCTTGTGTC
TTCAGTGGTGAATGTCACC: TCAGTGGTGAATGTCACCT
AACCTCTATAGGTGGCGAG: ACCTCTATAGGTGGCGAGA
CGTGTTTGCAATGAAGATG: GTGTTTGCAATGAAGATGG
AAGGGAGTTGGGTCGAAAA: AGGGAGTTGGGTCGAAAAA
TCGAATAGCCTGAATCCAG: CGAATAGCCTGAATCCAGA
GGAATTCAACTTTAGCAAC: GAATTCAACTTTAGCAACA
CGGATGCATTTCAGAGGGG: GGATGCATTTCAGAGGGGA
AACAGTGCAATATGTGGCG: ACAGTGCAATATGTGGCGA
ACATCGCCTCGCAGGCTGG: CATCGCCTCGCAGGCTGGG
ATATCTAGACTAAGGGCAT: TATCTAGACTAAGGGCATG
CAACATTTAACAAGCATCT: AACATTTAACAAGCATCTC
GCTCTGAGCGTTACGACGT: CTCTGAGCGTTACGACGTG
ACAGGCCTATAAAGCCACC: CAGGCCTATAAAGCCACCC
TCCAGACTGATTCGCGGTC: CCAGACTGATTCGCGGTCA
AAAAACAGGTACAGAATTT: AAAACAGGTACAGAATTTA
TTTCGGTTGCCTGACTGTC: TTCGGTTGCCTGACTGTCG
GAAGAAGGCTGCGTAGCTC: AAGAAGGCTGCGTAGCTCT
ACATTTATCAGCTCGCGAC: CATTTATCAGCTCGCGACG
GGTCATGCTGTTTTAACAC: GTCATGCTGTTTTAACACG
TTCGAACGAGACTCGAATA: TCGAACGAGACTCGAATAG
GTGAGTTGAACGTCTTACA: TGAGTTGAACGTCTTACAC
CCACGTTCGGTTCGATGCC: CACGTTCGGTTCGATGCCC
CCAACATTCTGCGAAGCAA: CAACATTCTGCGAAGCAAT
GTACCGATTTCTAGCGAGC: TACCGATTTCTAGCGAGCA
TCAGGGACACTGGGGTAGT: CAGGGACACTGGGGTAGTT
CCAAGATACATTACAATAG: CAAGATACATTACAATAGC
AGGGCCCCGCACCTCGCAG: GGGCCCCGCACCTCGCAGG
TATAAAGCCACCCAGCTGC: ATAAAGCCACCCAGCTGCG
GGGTCTTCCCTCGCAGGCT: GGTCTTCCCTCGCAGGCTG
TGGTGAATGTCACCTTGTT: GGTGAATGTCACCTTGTTC
ATATAAAAACGTGCTAGGG: TATAAAAACGTGCTAGGGA
TTAGGGCTGGGCTGAAGAA: TAGGGCTGGGCTGAAGAAG
TGGCCCAAAACCCAGACAA: GGCCCAAAACCCAGACAAC
ATGAGGGGCGCTTAGACTC: TGAGGGGCGCTTAGACTCG
CTAGGGAGGTAAAGGTCGC: TAGGGAGGTAAAGGTCGCA
ATCTGCCATGTCCAGTGTC: TCTGCCATGTCCAGTGTCA
TGATCTGATCACACATTAG: GATCTGATCACACATTAGA
CCCGCCGTATGACTCGAGA: CCGCCGTATGACTCGAGAT
CGTGTTGATGCACGAGGGC: GTGTTGATGCACGAGGGCT
CCTTAGGGCTGGGCTGAAG: CTTAGGGCTGGGCTGAAGA
TCGTTCATGAGTTCGATTA: CGTTCATGAGTTCGATTAC
CCTGTCTGTCGTTGCGTGG: CTGTCTGTCGTTGCGTGGC
TAACGCGTTCCCGACGGAT: AACGCGTTCCCGACGGATG
GATGCACGAGGGCTTGTAA: ATGCACGAGGGCTTGTAAC
ATGCTGTTTTAACACGTGT: TGCTGTTTTAACACGTGTT
TCACTCTTTGAAGAGTCCC: CACTCTTTGAAGAGTCCCG
CTGTTGTTATTTGCTACAG: TGTTGTTATTTGCTACAGC
GTAGGTCGAAAACATTGCT: TAGGTCGAAAACATTGCTC
TGCCATGTCCAGTGTCAAC: GCCATGTCCAGTGTCAACT
TTCAACTTTAGCAACATTT: TCAACTTTAGCAACATTTA
CCGCCGTATGACTCGAGAT: CGCCGTATGACTCGAGATG
GTTGTAGGTCGAAAACATT: TTGTAGGTCGAAAACATTG
AGTGGCAACCATACTGGGG: GTGGCAACCATACTGGGGT
TCCAGCCGCACAGCATGTT: CCAGCCGCACAGCATGTTG
GCTTTCATGGACAGGCCTA: CTTTCATGGACAGGCCTAT
ATCATTTCGAACGAGACTC: TCATTTCGAACGAGACTCG
ATGTACAAACCTCTATAGG: TGTACAAACCTCTATAGGT
GATGCATTTCAGAGGGGAT: ATGCATTTCAGAGGGGATT
GTTTCCAGCCGCACAGCAT: TTTCCAGCCGCACAGCATG
ACATTTAACAAGCATCTCG: CATTTAACAAGCATCTCGT
GAGTCCCGCCGGCAACACC: AGTCCCGCCGGCAACACCC
GCTGCGTGTTGATGCACGA: CTGCGTGTTGATGCACGAG
GCCGCCTCCCACCGAATCC: CCGCCTCCCACCGAATCCC
GCGCTTTGATTTCCCGAAT: CGCTTTGATTTCCCGAATC
TCGAAAACTTGCGCCCAAA: CGAAAACTTGCGCCCAAAA
GAAAACATTGCTCACTCTT: AAAACATTGCTCACTCTTT
AGAAGGCTGCGTAGCTCTG: GAAGGCTGCGTAGCTCTGA
TTGCCTGACTGTCGTCCCC: TGCCTGACTGTCGTCCCCT
GCTGGGCAACAGTTTCCTT: CTGGGCAACAGTTTCCTTC
AACGGATTCTGTCCTAGCG: ACGGATTCTGTCCTAGCGG
ATAAGCCGTCTTGCACTTA: TAAGCCGTCTTGCACTTAT
CCAAAAGCTAGAGAGGGGG: CAAAAGCTAGAGAGGGGGT
GAACCTGTCATATGGTACT: AACCTGTCATATGGTACTG
CTTGTGTCCGGGAGAGGTG: TTGTGTCCGGGAGAGGTGC
CCCAAGATACATTACAATA: CCAAGATACATTACAATAG
CTTTAAGTGGAAGGCTACG: TTTAAGTGGAAGGCTACGC
AGGTGCCGTATGGTGAAAC: GGTGCCGTATGGTGAAACC
ACGCGTTCCCGACGGATGC: CGCGTTCCCGACGGATGCA
ACTACAGTATTTTCGTTCA: CTACAGTATTTTCGTTCAT
TTCCTTCGGAATTCAACTT: TCCTTCGGAATTCAACTTT
TTCTGAAAGTGTATATTTT: TCTGAAAGTGTATATTTTT
GCAGTTATCAATGGTGGCT: CAGTTATCAATGGTGGCTT
ATGACAGAGGCTGACGGAT: TGACAGAGGCTGACGGATT
ATATAGCTAGGTTTCAGTG: TATAGCTAGGTTTCAGTGG
GAATACAGTAGGAAATTTC: AATACAGTAGGAAATTTCG
AGGGGCGCTTAGACTCGCT: GGGGCGCTTAGACTCGCTT
AGCCTGAATCCAGACTGAT: GCCTGAATCCAGACTGATT
ATCAACATCGAATTAGTCC: TCAACATCGAATTAGTCCT
GTAGCTCTGAGCGTTACGA: TAGCTCTGAGCGTTACGAC
ACGTGTTGTAGGTCGAAAA: CGTGTTGTAGGTCGAAAAC
GAGGGGGTAGTCCTGAGGA: AGGGGGTAGTCCTGAGGAC
TAAAGCCACCCAGCTGCGT: AAAGCCACCCAGCTGCGTG
ACATTAGACTTGAAAAGTT: CATTAGACTTGAAAAGTTG
ACTGTGAGTTGAACGTCTT: CTGTGAGTTGAACGTCTTA
GCAAAGCCTGATCTGATCA: CAAAGCCTGATCTGATCAC
GGAATAACATCGCCTCGCA: GAATAACATCGCCTCGCAG
CCAATCAACATCGAATTAG: CAATCAACATCGAATTAGT
ACTCGAGATGACAGAGGCT: CTCGAGATGACAGAGGCTG
GATCACACATTAGACTTGA: ATCACACATTAGACTTGAA
CGCCCAAAAGCTAGAGAGG: GCCCAAAAGCTAGAGAGGG
GGTTGACCGAGATTCCGGG: GTTGACCGAGATTCCGGGT
AGGTTTCAGTGGTGAATGT: GGTTTCAGTGGTGAATGTC
TTTCTAGCGAGCACGACGG: TTCTAGCGAGCACGACGGT
AACGTCCCGCCGTATGACT: ACGTCCCGCCGTATGACTC
GTTGCAGTCTAACCCTAAA: TTGCAGTCTAACCCTAAAA
GTTCACCTTGTCCATTCAT: TTCACCTTGTCCATTCATA
TGGGCTGAAGAAGGCTGCG: GGGCTGAAGAAGGCTGCGT
TTATATAAAAACGTGCTAG: TATATAAAAACGTGCTAGG
ACCAAGGGAGTTGGGTCGA: CCAAGGGAGTTGGGTCGAA
TCGCATGGGGCCGCCTCCC: CGCATGGGGCCGCCTCCCA
CAGACACTCCGATCTCGCC: AGACACTCCGATCTCGCCG
AAAACATTGCTCACTCTTT: AAACATTGCTCACTCTTTG
CCCAAAAGCTAGAGAGGGG: CCAAAAGCTAGAGAGGGGG
TGGGCATAGGTTTAAATCT: GGGCATAGGTTTAAATCTT
CCGATTTCTAGCGAGCACG: CGATTTCTAGCGAGCACGA
ATTCATATAGCTAGGTTTC: TTCATATAGCTAGGTTTCA
AATCGAAAAACAGGTACAG: ATCGAAAAACAGGTACAGA
TGAATGTCACCTTGTTCAA: GAATGTCACCTTGTTCAAT
AGTTGGGTCGAAAAACGAT: GTTGGGTCGAAAAACGATG
TAACACGTGTTGTAGGTCG: AACACGTGTTGTAGGTCGA
AGCGGAGCTCAAAAAGTCA: GCGGAGCTCAAAAAGTCAG
CTTACACCCAAGATACATT: TTACACCCAAGATACATTA
TTGCAAGGGCCCACCCTTA: TGCAAGGGCCCACCCTTAG
CTTGCATGCAACCCAGACA: TTGCATGCAACCCAGACAC
GGCGAGACAACGCACATTC: GCGAGACAACGCACATTCC
TGTTGCTTGTGTCCGGGAG: GTTGCTTGTGTCCGGGAGA
ATAGGCGTGCTCGTTTGCG: TAGGCGTGCTCGTTTGCGG
TTGATGCACGAGGGCTTGT: TGATGCACGAGGGCTTGTA
GCCCAAAAGCTAGAGAGGG: CCCAAAAGCTAGAGAGGGG
GCGCCCAAAAGCTAGAGAG: CGCCCAAAAGCTAGAGAGG
GCCGCGTTATATAAAAACG: CCGCGTTATATAAAAACGT
TTCCTTCTGAAAGTGTATA: TCCTTCTGAAAGTGTATAT
GTTTTAACACGTGTTGTAG: TTTTAACACGTGTTGTAGG
CGTGCTAGGGAGGTAAAGG: GTGCTAGGGAGGTAAAGGT
ACATTCCTAGGGGTGACTA: CATTCCTAGGGGTGACTAA
CTTTGAAGAGTCCCGCCGG: TTTGAAGAGTCCCGCCGGC
TTTTCGTTCATGAGTTCGA: TTTCGTTCATGAGTTCGAT
GAGATTCCGGGTCATGCTG: AGATTCCGGGTCATGCTGT
CTGATCGAGTGCGATCACT: TGATCGAGTGCGATCACTG
ACATTGCTCACTCTTTGAA: CATTGCTCACTCTTTGAAG
CGCAGGCTGGGCAACAAGT: GCAGGCTGGGCAACAAGTT
GGCTACGCGTCGGGCTGGC: GCTACGCGTCGGGCTGGCC
TTCGAAATACGACGTCTTG: TCGAAATACGACGTCTTGC
TCGAGTGCGATCACTGTTG: CGAGTGCGATCACTGTTGT
GGGGTAGTTCCAATGTTCC: GGGTAGTTCCAATGTTCCC
GGCCGCCTCCCACCGAATC: GCCGCCTCCCACCGAATCC
ACCCTCCGCCCACATAGAA: CCCTCCGCCCACATAGAAG
TACACTTCACTACAGTATT: ACACTTCACTACAGTATTT
GTACTGGGCATAGGTTTAA: TACTGGGCATAGGTTTAAA
TTGTATTGCCTCCTTTAAG: TGTATTGCCTCCTTTAAGT
AAGATGGGGATCGTGTTGT: AGATGGGGATCGTGTTGTT
AATGCCAAGCCCCACACCA: ATGCCAAGCCCCACACCAT
TCCTCGCAGGCTGGGCAAC: CCTCGCAGGCTGGGCAACA
TTCCAGCCGCACAGCATGT: TCCAGCCGCACAGCATGTT
AGCTAGGTTTCAGTGGTGA: GCTAGGTTTCAGTGGTGAA
CTGGGCAACAATCCTATTC: TGGGCAACAATCCTATTCC
GTTCTCTTAAATAAGTTGT: TTCTCTTAAATAAGTTGTC
CCCCACACCATATCTAGAC: CCCACACCATATCTAGACT
CGACGGATGCATTTCAGAG: GACGGATGCATTTCAGAGG
GTCTGCCGTGGTACTTGTT: TCTGCCGTGGTACTTGTTC
GCATGGGGCCGCCTCCCAC: CATGGGGCCGCCTCCCACC
GAATTTAGCTACTCCTGTT: AATTTAGCTACTCCTGTTT
CGAGAGTAAGAGGACTGGG: GAGAGTAAGAGGACTGGGG
CGTGGTACTTGTTCAACCG: GTGGTACTTGTTCAACCGC
CTCCTCGCAGGCTGGGCAA: TCCTCGCAGGCTGGGCAAC
CGGTCATGAAGATTTCCTT: GGTCATGAAGATTTCCTTC
ATTGCCTCCTTTAAGTGGA: TTGCCTCCTTTAAGTGGAA
TCGAAAAACGATGAGGGGC: CGAAAAACGATGAGGGGCG
TTCTGTCCTAGCGGAGCTC: TCTGTCCTAGCGGAGCTCA
CAGGCTGGGCAACAAGTTC: AGGCTGGGCAACAAGTTCT
CAACTTTAGCAACATTTAA: AACTTTAGCAACATTTAAC
TAAATAAGTTGTCGCTTGC: AAATAAGTTGTCGCTTGCC
GCAGGCTGGGCAACAGTTT: CAGGCTGGGCAACAGTTTC
GCGTCATCACGTCCACGTT: CGTCATCACGTCCACGTTC
TCACTACAGTATTTTCGTT: CACTACAGTATTTTCGTTC
AACCCTAAAACCAATCAAC: ACCCTAAAACCAATCAACA
GCGATGCGCTATACCATCG: CGATGCGCTATACCATCGT
AACAGGTACAGAATTTAGC: ACAGGTACAGAATTTAGCT
AAGTCAGCCTCGGTTTCCA: AGTCAGCCTCGGTTTCCAG
TGTTCAACCGCGTCATCAC: GTTCAACCGCGTCATCACG
GACTAAGGGCATGTAACCT: ACTAAGGGCATGTAACCTT
CCGAGATTCCGGGTCATGC: CGAGATTCCGGGTCATGCT
CCAGACTGATTCGCGGTCA: CAGACTGATTCGCGGTCAT
TAGTTCCAATGGAATAACA: AGTTCCAATGGAATAACAT
GCAGGCTGGGCAACAATCC: CAGGCTGGGCAACAATCCT
AAACCCTTATCAGTACTGT: AACCCTTATCAGTACTGTC
CATATGGTACTGGGCATAG: ATATGGTACTGGGCATAGG
CACGTGTTGTAGGTCGAAA: ACGTGTTGTAGGTCGAAAA
GACGGATGCATTTCAGAGG: ACGGATGCATTTCAGAGGG
TGTCCATTCATATAGCTAG: GTCCATTCATATAGCTAGG
TTCCAATGTTCCCGATCCT: TCCAATGTTCCCGATCCTC
AAAAGTTGAAGCACGTGTT: AAAGTTGAAGCACGTGTTG
CGGCATGTAAGTACCGATT: GGCATGTAAGTACCGATTT
TATGACTCGAGATGACAGA: ATGACTCGAGATGACAGAG
TGCAATATGTGGCGATAAG: GCAATATGTGGCGATAAGG
CACATTCCTAGGGGTGACT: ACATTCCTAGGGGTGACTA
AACGTCTTTTGTATCAGTG: ACGTCTTTTGTATCAGTGT
CAGTCTGCCGTGGTACTTG: AGTCTGCCGTGGTACTTGT
AGCTAGAGAGGGGGTAGTC: GCTAGAGAGGGGGTAGTCC
TCGATCCAGGCAGTCACAA: CGATCCAGGCAGTCACAAG
GAAGATGGGGATCGTGTTG: AAGATGGGGATCGTGTTGT
TAGCAACATTTAACAAGCA: AGCAACATTTAACAAGCAT
TCCTGTTTGTATTGCCTCC: CCTGTTTGTATTGCCTCCT
GACTGGGGTAGTTCCAATG: ACTGGGGTAGTTCCAATGG
TACGCGTCGGGCTGGCCCA: ACGCGTCGGGCTGGCCCAA
TTTGCGGCATGTAAGTACC: TTGCGGCATGTAAGTACCG
CGGCTCAGTACCGGAATAG: GGCTCAGTACCGGAATAGA
ACCCTAAAACCAATCAACA: CCCTAAAACCAATCAACAT
ACAGTGCAATATGTGGCGA: CAGTGCAATATGTGGCGAT
TTAACAAGCATCTCGTGGC: TAACAAGCATCTCGTGGCC
GTTACAGCACCCGCTCTTG: TTACAGCACCCGCTCTTGC
TACTCCTGTTTGTATTGCC: ACTCCTGTTTGTATTGCCT
CAGACCACCAAGGGAGTTG: AGACCACCAAGGGAGTTGG
ACCCGGGCTGATCTTACAC: CCCGGGCTGATCTTACACT
AGGACACAGCCTGGGAGGT: GGACACAGCCTGGGAGGTG
CGAACGAGACTCGAATAGC: GAACGAGACTCGAATAGCC
CATCACGTCCACGTTCGGT: ATCACGTCCACGTTCGGTT
AAGTACCGATTTCTAGCGA: AGTACCGATTTCTAGCGAG
CCTCCCACCGAATCCCTCG: CTCCCACCGAATCCCTCGA
AGTTTCCTTCGGAATTCAA: GTTTCCTTCGGAATTCAAC
CAACATCGAATTAGTCCTC: AACATCGAATTAGTCCTCG
CGACGTGTTTGCAATGAAG: GACGTGTTTGCAATGAAGA
ACCAACATTCTGCGAAGCA: CCAACATTCTGCGAAGCAA
TGACTCGAGATGACAGAGG: GACTCGAGATGACAGAGGC
GAAAAGGCGATGCGCTATA: AAAAGGCGATGCGCTATAC
GATGAGGGGCGCTTAGACT: ATGAGGGGCGCTTAGACTC
ATTTAACAAGCATCTCGTG: TTTAACAAGCATCTCGTGG
CCTAAATGCCAATAAGCCG: CTAAATGCCAATAAGCCGT
CCCTCGATCCAGGCAGTCA: CCTCGATCCAGGCAGTCAC
TTAGACTCGCTTGCATGCA: TAGACTCGCTTGCATGCAA
AGGTAAAGGTCGCACTTTG: GGTAAAGGTCGCACTTTGA
AAATGCCAATAAGCCGTCT: AATGCCAATAAGCCGTCTT
CCAGACAACTGTGAGTTGA: CAGACAACTGTGAGTTGAA
GATTCCGGGTCATGCTGTT: ATTCCGGGTCATGCTGTTT
GGACAGGCCTATAAAGCCA: GACAGGCCTATAAAGCCAC
CGATCCTCCTCGCAGGCTG: GATCCTCCTCGCAGGCTGG
CGGAATTCAACTTTAGCAA: GGAATTCAACTTTAGCAAC
TGCTAGGGAGGTAAAGGTC: GCTAGGGAGGTAAAGGTCG
CTTGTGAATACAGTAGGAA: TTGTGAATACAGTAGGAAA
GACCGCTTGGTAGGAATGC: ACCGCTTGGTAGGAATGCC
CTCAAAAAGTCAGCCTCGG: TCAAAAAGTCAGCCTCGGT
GCTTGGTAGGAATGCCAAG: CTTGGTAGGAATGCCAAGC
TTTGGTTGACCGAGATTCC: TTGGTTGACCGAGATTCCG
AACCCAGACAACTGTGAGT: ACCCAGACAACTGTGAGTT
GGTGAAACCCTTATCAGTA: GTGAAACCCTTATCAGTAC
AGGTATCGAAAACTTGCGC: GGTATCGAAAACTTGCGCC
TAGGTCGAAAACATTGCTC: AGGTCGAAAACATTGCTCA
CGCTTTGATTTCCCGAATC: GCTTTGATTTCCCGAATCT
CAGGTACAGAATTTAGCTA: AGGTACAGAATTTAGCTAC
GTCGCTTGCCTGTCTGTCG: TCGCTTGCCTGTCTGTCGT
CCCGCACCTCGCAGGCTGG: CCGCACCTCGCAGGCTGGG
CGCTATACCATCGTTCACC: GCTATACCATCGTTCACCT
TATAAAAACGTGCTAGGGA: ATAAAAACGTGCTAGGGAG
GGCGTGCTCGTTTGCGGCA: GCGTGCTCGTTTGCGGCAT
ATCCAAGCAGTCTGCCGTG: TCCAAGCAGTCTGCCGTGG
GTTCGATTACAACGTCCCG: TTCGATTACAACGTCCCGC
AGTTGAAGCACGTGTTGCA: GTTGAAGCACGTGTTGCAG
CAACAATCCTATTCCTAAA: AACAATCCTATTCCTAAAT
GTTAAAACCTTCCCCGAGG: TTAAAACCTTCCCCGAGGA
CCAAGGGAGTTGGGTCGAA: CAAGGGAGTTGGGTCGAAA
CCCACCCGGGCTGATCTTA: CCACCCGGGCTGATCTTAC
CGCATGGGGCCGCCTCCCA: GCATGGGGCCGCCTCCCAC
GGCAACAGTTTCCTTCGGA: GCAACAGTTTCCTTCGGAA
TTCATATTCAGGGACACTG: TCATATTCAGGGACACTGG
TGTTGTTAAAACCTTCCCC: GTTGTTAAAACCTTCCCCG
AGTGTCAACTGGGGTAGTT: GTGTCAACTGGGGTAGTTC
GAGGTAAAGGTCGCACTTT: AGGTAAAGGTCGCACTTTG
AATAACATCGCCTCGCAGG: ATAACATCGCCTCGCAGGC
GTCTTGCAAGGGCCCACCC: TCTTGCAAGGGCCCACCCT
AGGGAGTTGGGTCGAAAAA: GGGAGTTGGGTCGAAAAAC
TATCATTTCGAACGAGACT: ATCATTTCGAACGAGACTC
TAATGTACAAACCTCTATA: AATGTACAAACCTCTATAG
GGCCCAAAACCCAGACAAC: GCCCAAAACCCAGACAACT
CGTTCATGAGTTCGATTAC: GTTCATGAGTTCGATTACA
GCCTGGGAGGTGATGAATG: CCTGGGAGGTGATGAATGT
CAATGAAGATGGGGATCGT: AATGAAGATGGGGATCGTG
AGACTAAGGGCATGTAACC: GACTAAGGGCATGTAACCT
GCTGATCTTACACTTCACT: CTGATCTTACACTTCACTA
CACTCCGATCTCGCCGCGC: ACTCCGATCTCGCCGCGCT
TTCGGTTGCCTGACTGTCG: TCGGTTGCCTGACTGTCGT
CGAAATACGACGTCTTGCA: GAAATACGACGTCTTGCAA
TGTCCGGGAGAGGTGCCGT: GTCCGGGAGAGGTGCCGTA
TTGTTCAATGAGATTTAAC: TGTTCAATGAGATTTAACG
AAATCTTGCTTTCATGGAC: AATCTTGCTTTCATGGACA
GCAATGAAGATGGGGATCG: CAATGAAGATGGGGATCGT
CCTAGGGGTGACTAACTAA: CTAGGGGTGACTAACTAAT
GTAGTTCCAATGCGAGGGT: TAGTTCCAATGCGAGGGTC
GTCCAGTGTCAACTGGGGT: TCCAGTGTCAACTGGGGTA
GAGGACACAGCCTGGGAGG: AGGACACAGCCTGGGAGGT
ACCGAGATTCCGGGTCATG: CCGAGATTCCGGGTCATGC
AGTTGAACGTCTTACACCC: GTTGAACGTCTTACACCCA
GCACCCGCTCTTGCCTCCT: CACCCGCTCTTGCCTCCTC
GCGACGGCTCAGTACCGGA: CGACGGCTCAGTACCGGAA
TAGGTTTCAGTGGTGAATG: AGGTTTCAGTGGTGAATGT
GGGTAGTCCTGAGGACACA: GGTAGTCCTGAGGACACAG
AAAACCCAGACAACTGTGA: AAACCCAGACAACTGTGAG
GTCCATTCATATAGCTAGG: TCCATTCATATAGCTAGGT
ATTTCCCGAATCTGCCATG: TTTCCCGAATCTGCCATGT
TACCGATTTCTAGCGAGCA: ACCGATTTCTAGCGAGCAC
AATCTGCCATGTCCAGTGT: ATCTGCCATGTCCAGTGTC
CCGATCTCGCCGCGCTTTG: CGATCTCGCCGCGCTTTGA
GGGCAACAATCCTATTCCT: GGCAACAATCCTATTCCTA
