CACCGTTAGCC: ACCGTTAGCCC
ACCGTTAGCCC: CCGTTAGCCCA
CCGTTAGCCCA: CGTTAGCCCAG
CGTTAGCCCAG: GTTAGCCCAGA
GTTAGCCCAGA: TTAGCCCAGAT
TTAGCCCAGAT: TAGCCCAGATG
TAGCCCAGATG: AGCCCAGATGC
AGCCCAGATGC: GCCCAGATGCC
GCCCAGATGCC: CCCAGATGCCT
CCCAGATGCCT: CCAGATGCCTT
CCAGATGCCTT: CAGATGCCTTC
CAGATGCCTTC: AGATGCCTTCG
AGATGCCTTCG: GATGCCTTCGC
GATGCCTTCGC: ATGCCTTCGCG
ATGCCTTCGCG: TGCCTTCGCGG
TGCCTTCGCGG: GCCTTCGCGGT
GCCTTCGCGGT: CCTTCGCGGTG
CCTTCGCGGTG: CTTCGCGGTGT
CTTCGCGGTGT: TTCGCGGTGTG
TTCGCGGTGTG: TCGCGGTGTGC
TCGCGGTGTGC: CGCGGTGTGCG
CGCGGTGTGCG: GCGGTGTGCGT
GCGGTGTGCGT: CGGTGTGCGTT
CGGTGTGCGTT: GGTGTGCGTTC
GGTGTGCGTTC: GTGTGCGTTCG
GTGTGCGTTCG: TGTGCGTTCGC
TGTGCGTTCGC: GTGCGTTCGCC
GTGCGTTCGCC: TGCGTTCGCCT
TGCGTTCGCCT: GCGTTCGCCTG
GCGTTCGCCTG: CGTTCGCCTGA
CGTTCGCCTGA: GTTCGCCTGAA
GTTCGCCTGAA: TTCGCCTGAAC
TTCGCCTGAAC: TCGCCTGAACT
TCGCCTGAACT: CGCCTGAACTA
CGCCTGAACTA: GCCTGAACTAT
GCCTGAACTAT: CCTGAACTATG
CCTGAACTATG: CTGAACTATGG
CTGAACTATGG: TGAACTATGGG
TGAACTATGGG: GAACTATGGGG
GAACTATGGGG: AACTATGGGGC
AACTATGGGGC: ACTATGGGGCC
ACTATGGGGCC: CTATGGGGCCT
CTATGGGGCCT: TATGGGGCCTT
TATGGGGCCTT: ATGGGGCCTTG
ATGGGGCCTTG: TGGGGCCTTGT
TGGGGCCTTGT: GGGGCCTTGTA
GGGGCCTTGTA: GGGCCTTGTAT
GGGCCTTGTAT: GGCCTTGTATG
GGCCTTGTATG: GCCTTGTATGT
GCCTTGTATGT: CCTTGTATGTG
CCTTGTATGTG: CTTGTATGTGA
CTTGTATGTGA: TTGTATGTGAG
TTGTATGTGAG: TGTATGTGAGA
TGTATGTGAGA: GTATGTGAGAT
GTATGTGAGAT: TATGTGAGATG
TATGTGAGATG: ATGTGAGATGC
ATGTGAGATGC: TGTGAGATGCC
TGTGAGATGCC: GTGAGATGCCG
GTGAGATGCCG: TGAGATGCCGG
TGAGATGCCGG: GAGATGCCGGT
GAGATGCCGGT: AGATGCCGGTA
AGATGCCGGTA: GATGCCGGTAT
GATGCCGGTAT: ATGCCGGTATC
ATGCCGGTATC: TGCCGGTATCT
TGCCGGTATCT: GCCGGTATCTC
GCCGGTATCTC: CCGGTATCTCG
CCGGTATCTCG: CGGTATCTCGC
CGGTATCTCGC: GGTATCTCGCT
GGTATCTCGCT: GTATCTCGCTC
GTATCTCGCTC: TATCTCGCTCT
TATCTCGCTCT: ATCTCGCTCTC
ATCTCGCTCTC: TCTCGCTCTCA
TCTCGCTCTCA: CTCGCTCTCAA
CTCGCTCTCAA: TCGCTCTCAAG
TCGCTCTCAAG: CGCTCTCAAGT
CGCTCTCAAGT: GCTCTCAAGTT
GCTCTCAAGTT: CTCTCAAGTTT
CTCTCAAGTTT: TCTCAAGTTTT
TCTCAAGTTTT: CTCAAGTTTTA
CTCAAGTTTTA: TCAAGTTTTAA
TCAAGTTTTAA: CAAGTTTTAAA
CAAGTTTTAAA: AAGTTTTAAAT
AAGTTTTAAAT: AGTTTTAAATC
AGTTTTAAATC: GTTTTAAATCG
GTTTTAAATCG: TTTTAAATCGG
TTTTAAATCGG: TTTAAATCGGA
TTTAAATCGGA: TTAAATCGGAA
TTAAATCGGAA: TAAATCGGAAA
TAAATCGGAAA: AAATCGGAAAA AAATCGGAAAC
AAATCGGAAAC: AATCGGAAACC
AATCGGAAACC: ATCGGAAACCA
ATCGGAAACCA: TCGGAAACCAA
TCGGAAACCAA: CGGAAACCAAC
CGGAAACCAAC: GGAAACCAACT
GGAAACCAACT: GAAACCAACTG
GAAACCAACTG: AAACCAACTGA
AAACCAACTGA: AACCAACTGAC
AACCAACTGAC: ACCAACTGACA
ACCAACTGACA: CCAACTGACAC
CCAACTGACAC: CAACTGACACA
CAACTGACACA: AACTGACACAA
AACTGACACAA: ACTGACACAAC
ACTGACACAAC: CTGACACAACC
CTGACACAACC: TGACACAACCA
TGACACAACCA: GACACAACCAT
GACACAACCAT: ACACAACCATG
ACACAACCATG: CACAACCATGG
CACAACCATGG: ACAACCATGGG
ACAACCATGGG: CAACCATGGGT
CAACCATGGGT: AACCATGGGTA
AACCATGGGTA: ACCATGGGTAA
ACCATGGGTAA: CCATGGGTAAT
CCATGGGTAAT: CATGGGTAATG
CATGGGTAATG: ATGGGTAATGT
ATGGGTAATGT: TGGGTAATGTC
TGGGTAATGTC: GGGTAATGTCA
GGGTAATGTCA: GGTAATGTCAC
GGTAATGTCAC: GTAATGTCACT
GTAATGTCACT: TAATGTCACTA
TAATGTCACTA: AATGTCACTAA
AATGTCACTAA: ATGTCACTAAT
ATGTCACTAAT: TGTCACTAATG
TGTCACTAATG: GTCACTAATGT
GTCACTAATGT: TCACTAATGTC
TCACTAATGTC: CACTAATGTCT
CACTAATGTCT: ACTAATGTCTA
ACTAATGTCTA: CTAATGTCTAG
CTAATGTCTAG: TAATGTCTAGA
TAATGTCTAGA: AATGTCTAGAG
AATGTCTAGAG: ATGTCTAGAGA
ATGTCTAGAGA: TGTCTAGAGAG
TGTCTAGAGAG: GTCTAGAGAGA
GTCTAGAGAGA: TCTAGAGAGAA
TCTAGAGAGAA: CTAGAGAGAAT
CTAGAGAGAAT: TAGAGAGAATG
TAGAGAGAATG: AGAGAGAATGG
AGAGAGAATGG: GAGAGAATGGT
GAGAGAATGGT: AGAGAATGGTC
AGAGAATGGTC: GAGAATGGTCT
GAGAATGGTCT: AGAATGGTCTC
AGAATGGTCTC: GAATGGTCTCT
GAATGGTCTCT: AATGGTCTCTG
AATGGTCTCTG: ATGGTCTCTGC
ATGGTCTCTGC: TGGTCTCTGCC
TGGTCTCTGCC: GGTCTCTGCCA
GGTCTCTGCCA: GTCTCTGCCAA
GTCTCTGCCAA: TCTCTGCCAAT
TCTCTGCCAAT: CTCTGCCAATT
CTCTGCCAATT: TCTGCCAATTA
TCTGCCAATTA: CTGCCAATTAG
CTGCCAATTAG: TGCCAATTAGA
TGCCAATTAGA: GCCAATTAGAT
GCCAATTAGAT: CCAATTAGATA
CCAATTAGATA: CAATTAGATAG
CAATTAGATAG: AATTAGATAGT
AATTAGATAGT: ATTAGATAGTT
ATTAGATAGTT: TTAGATAGTTG
TTAGATAGTTG: TAGATAGTTGC
TAGATAGTTGC: AGATAGTTGCC
AGATAGTTGCC: GATAGTTGCCT
GATAGTTGCCT: ATAGTTGCCTC
ATAGTTGCCTC: TAGTTGCCTCC
TAGTTGCCTCC: AGTTGCCTCCA
AGTTGCCTCCA: GTTGCCTCCAC
GTTGCCTCCAC: TTGCCTCCACC
TTGCCTCCACC: TGCCTCCACCT
TGCCTCCACCT: GCCTCCACCTG
GCCTCCACCTG: CCTCCACCTGC
CCTCCACCTGC: CTCCACCTGCG
CTCCACCTGCG: TCCACCTGCGC
TCCACCTGCGC: CCACCTGCGCA
CCACCTGCGCA: CACCTGCGCAA
CACCTGCGCAA: ACCTGCGCAAG
ACCTGCGCAAG: CCTGCGCAAGG
CCTGCGCAAGG: CTGCGCAAGGC
CTGCGCAAGGC: TGCGCAAGGCT
TGCGCAAGGCT: GCGCAAGGCTG
GCGCAAGGCTG: CGCAAGGCTGT
CGCAAGGCTGT: GCAAGGCTGTC
GCAAGGCTGTC: CAAGGCTGTCG
CAAGGCTGTCG: AAGGCTGTCGG
AAGGCTGTCGG: AGGCTGTCGGT
AGGCTGTCGGT: GGCTGTCGGTT
GGCTGTCGGTT: GCTGTCGGTTT
GCTGTCGGTTT: CTGTCGGTTTC
CTGTCGGTTTC: TGTCGGTTTCA
TGTCGGTTTCA: GTCGGTTTCAG
GTCGGTTTCAG: TCGGTTTCAGG
TCGGTTTCAGG: CGGTTTCAGGA
CGGTTTCAGGA: GGTTTCAGGAA
GGTTTCAGGAA: GTTTCAGGAAG
GTTTCAGGAAG: TTTCAGGAAGC
TTTCAGGAAGC: TTCAGGAAGCG
TTCAGGAAGCG: TCAGGAAGCGC
TCAGGAAGCGC: CAGGAAGCGCC
CAGGAAGCGCC: AGGAAGCGCCT
AGGAAGCGCCT: GGAAGCGCCTA
GGAAGCGCCTA: GAAGCGCCTAT
GAAGCGCCTAT: AAGCGCCTATG
AAGCGCCTATG: AGCGCCTATGC
AGCGCCTATGC: GCGCCTATGCA
GCGCCTATGCA: CGCCTATGCAC
CGCCTATGCAC: GCCTATGCACC
GCCTATGCACC: CCTATGCACCC
CCTATGCACCC: CTATGCACCCT
CTATGCACCCT: TATGCACCCTA
TATGCACCCTA: ATGCACCCTAC
ATGCACCCTAC: TGCACCCTACG
TGCACCCTACG: GCACCCTACGG
GCACCCTACGG: CACCCTACGGC
CACCCTACGGC: ACCCTACGGCG
ACCCTACGGCG: CCCTACGGCGC
CCCTACGGCGC: CCTACGGCGCA
CCTACGGCGCA: CTACGGCGCAT
CTACGGCGCAT: TACGGCGCATA
TACGGCGCATA: ACGGCGCATAC
ACGGCGCATAC: CGGCGCATACT
CGGCGCATACT: GGCGCATACTC
GGCGCATACTC: GCGCATACTCG
GCGCATACTCG: CGCATACTCGG
CGCATACTCGG: GCATACTCGGC
GCATACTCGGC: CATACTCGGCA
CATACTCGGCA: ATACTCGGCAG
ATACTCGGCAG: TACTCGGCAGA
TACTCGGCAGA: ACTCGGCAGAA
ACTCGGCAGAA: CTCGGCAGAAA
CTCGGCAGAAA: TCGGCAGAAAC
TCGGCAGAAAC: CGGCAGAAACC
CGGCAGAAACC: GGCAGAAACCT
GGCAGAAACCT: GCAGAAACCTG
GCAGAAACCTG: CAGAAACCTGT
CAGAAACCTGT: AGAAACCTGTA
AGAAACCTGTA: GAAACCTGTAG
GAAACCTGTAG: AAACCTGTAGG
AAACCTGTAGG: AACCTGTAGGT
AACCTGTAGGT: ACCTGTAGGTG
ACCTGTAGGTG: CCTGTAGGTGG
CCTGTAGGTGG: CTGTAGGTGGA
CTGTAGGTGGA: TGTAGGTGGAC
TGTAGGTGGAC: GTAGGTGGACT
GTAGGTGGACT: TAGGTGGACTC
TAGGTGGACTC: AGGTGGACTCG
AGGTGGACTCG: GGTGGACTCGT
GGTGGACTCGT: GTGGACTCGTT
GTGGACTCGTT: TGGACTCGTTC
TGGACTCGTTC: GGACTCGTTCC
GGACTCGTTCC: GACTCGTTCCT
GACTCGTTCCT: ACTCGTTCCTA
ACTCGTTCCTA: CTCGTTCCTAG
CTCGTTCCTAG: TCGTTCCTAGG
TCGTTCCTAGG: CGTTCCTAGGC
CGTTCCTAGGC: GTTCCTAGGCA
GTTCCTAGGCA: TTCCTAGGCAT
TTCCTAGGCAT: TCCTAGGCATA
TCCTAGGCATA: CCTAGGCATAT
CCTAGGCATAT: CTAGGCATATT
CTAGGCATATT: TAGGCATATTT
TAGGCATATTT: AGGCATATTTA
AGGCATATTTA: GGCATATTTAT
GGCATATTTAT: GCATATTTATG
GCATATTTATG: CATATTTATGC
CATATTTATGC: ATATTTATGCG
ATATTTATGCG: TATTTATGCGT
TATTTATGCGT: ATTTATGCGTC
ATTTATGCGTC: TTTATGCGTCG
TTTATGCGTCG: TTATGCGTCGA
TTATGCGTCGA: TATGCGTCGAA
TATGCGTCGAA: ATGCGTCGAAC
ATGCGTCGAAC: TGCGTCGAACG
TGCGTCGAACG: GCGTCGAACGG
GCGTCGAACGG: CGTCGAACGGT
CGTCGAACGGT: GTCGAACGGTG
GTCGAACGGTG: TCGAACGGTGA
TCGAACGGTGA: CGAACGGTGAG
CGAACGGTGAG: GAACGGTGAGA
GAACGGTGAGA: AACGGTGAGAG
AACGGTGAGAG: ACGGTGAGAGT
ACGGTGAGAGT: CGGTGAGAGTT
CGGTGAGAGTT: GGTGAGAGTTT
GGTGAGAGTTT: GTGAGAGTTTT
GTGAGAGTTTT: TGAGAGTTTTC
TGAGAGTTTTC: GAGAGTTTTCT
GAGAGTTTTCT: AGAGTTTTCTT
AGAGTTTTCTT: GAGTTTTCTTA
GAGTTTTCTTA: AGTTTTCTTAT
AGTTTTCTTAT: GTTTTCTTATC
GTTTTCTTATC: TTTTCTTATCA
TTTTCTTATCA: TTTCTTATCAC
TTTCTTATCAC: TTCTTATCACA
TTCTTATCACA: TCTTATCACAC
TCTTATCACAC: CTTATCACACT
CTTATCACACT: TTATCACACTT
TTATCACACTT: TATCACACTTG
TATCACACTTG: ATCACACTTGG
ATCACACTTGG: TCACACTTGGT
TCACACTTGGT: CACACTTGGTC
CACACTTGGTC: ACACTTGGTCC
ACACTTGGTCC: CACTTGGTCCT
CACTTGGTCCT: ACTTGGTCCTG
ACTTGGTCCTG: CTTGGTCCTGC
CTTGGTCCTGC: TTGGTCCTGCT
TTGGTCCTGCT: TGGTCCTGCTG
TGGTCCTGCTG: GGTCCTGCTGA
GGTCCTGCTGA: GTCCTGCTGAA
GTCCTGCTGAA: TCCTGCTGAAA
TCCTGCTGAAA: CCTGCTGAAAA
CCTGCTGAAAA: CTGCTGAAAAT
CTGCTGAAAAT: TGCTGAAAATG
TGCTGAAAATG: GCTGAAAATGC
GCTGAAAATGC: CTGAAAATGCC
CTGAAAATGCC: TGAAAATGCCT
TGAAAATGCCT: GAAAATGCCTT
GAAAATGCCTT: AAAATGCCTTT
AAAATGCCTTT: AAATGCCTTTT
AAATGCCTTTT: AATGCCTTTTA
AATGCCTTTTA: ATGCCTTTTAG
ATGCCTTTTAG: TGCCTTTTAGT
TGCCTTTTAGT: GCCTTTTAGTC
GCCTTTTAGTC: CCTTTTAGTCG
CCTTTTAGTCG: CTTTTAGTCGG
CTTTTAGTCGG: TTTTAGTCGGT
TTTTAGTCGGT: TTTAGTCGGTC
TTTAGTCGGTC: TTAGTCGGTCT
TTAGTCGGTCT: TAGTCGGTCTT
TAGTCGGTCTT: AGTCGGTCTTC
AGTCGGTCTTC: GTCGGTCTTCC
GTCGGTCTTCC: TCGGTCTTCCT
TCGGTCTTCCT: CGGTCTTCCTG
CGGTCTTCCTG: GGTCTTCCTGG
GGTCTTCCTGG: GTCTTCCTGGT
GTCTTCCTGGT: TCTTCCTGGTA
TCTTCCTGGTA: CTTCCTGGTAA
CTTCCTGGTAA: TTCCTGGTAAA
TTCCTGGTAAA: TCCTGGTAAAA
TCCTGGTAAAA: CCTGGTAAAAG
CCTGGTAAAAG: CTGGTAAAAGG
CTGGTAAAAGG: TGGTAAAAGGT
TGGTAAAAGGT: GGTAAAAGGTT
GGTAAAAGGTT: GTAAAAGGTTC
GTAAAAGGTTC: TAAAAGGTTCC
TAAAAGGTTCC: AAAAGGTTCCC
AAAAGGTTCCC: AAAGGTTCCCA
AAAGGTTCCCA: AAGGTTCCCAT
AAGGTTCCCAT: AGGTTCCCATT
AGGTTCCCATT: GGTTCCCATTG
GGTTCCCATTG: GTTCCCATTGT
GTTCCCATTGT: TTCCCATTGTT
TTCCCATTGTT: TCCCATTGTTA
TCCCATTGTTA: CCCATTGTTAC
CCCATTGTTAC: CCATTGTTACT
CCATTGTTACT: CATTGTTACTA
CATTGTTACTA: ATTGTTACTAT
ATTGTTACTAT: TTGTTACTATG
TTGTTACTATG: TGTTACTATGT
TGTTACTATGT: GTTACTATGTT
GTTACTATGTT: TTACTATGTTA
TTACTATGTTA: TACTATGTTAA
TACTATGTTAA: ACTATGTTAAA
ACTATGTTAAA: CTATGTTAAAG
CTATGTTAAAG: TATGTTAAAGA
TATGTTAAAGA: ATGTTAAAGAT
ATGTTAAAGAT: TGTTAAAGATC
TGTTAAAGATC: GTTAAAGATCG
GTTAAAGATCG: TTAAAGATCGA
TTAAAGATCGA: TAAAGATCGAA
TAAAGATCGAA: AAAGATCGAAA
AAAGATCGAAA: AAGATCGAAAA
AAGATCGAAAA: AGATCGAAAAT
AGATCGAAAAT: GATCGAAAATG
GATCGAAAATG: ATCGAAAATGA
ATCGAAAATGA: TCGAAAATGAC
TCGAAAATGAC: CGAAAATGACA
CGAAAATGACA: GAAAATGACAC
GAAAATGACAC: AAAATGACACA
AAAATGACACA: AAATGACACAG
AAATGACACAG: AATGACACAGG
AATGACACAGG: ATGACACAGGA
ATGACACAGGA: TGACACAGGAC
TGACACAGGAC: GACACAGGACA
GACACAGGACA: ACACAGGACAG
ACACAGGACAG: CACAGGACAGA
CACAGGACAGA: ACAGGACAGAC
ACAGGACAGAC: CAGGACAGACC
CAGGACAGACC: AGGACAGACCG
AGGACAGACCG: GGACAGACCGT
GGACAGACCGT: GACAGACCGTA
GACAGACCGTA: ACAGACCGTAA
ACAGACCGTAA: CAGACCGTAAC
CAGACCGTAAC: AGACCGTAACG
AGACCGTAACG: GACCGTAACGC
GACCGTAACGC: ACCGTAACGCC
ACCGTAACGCC: CCGTAACGCCG
CCGTAACGCCG: CGTAACGCCGT
CGTAACGCCGT: GTAACGCCGTA
GTAACGCCGTA: TAACGCCGTAC
TAACGCCGTAC: AACGCCGTACA
AACGCCGTACA: ACGCCGTACAC
ACGCCGTACAC: CGCCGTACACG
CGCCGTACACG: GCCGTACACGG
GCCGTACACGG: CCGTACACGGA
CCGTACACGGA: CGTACACGGAT
CGTACACGGAT: GTACACGGATA
GTACACGGATA: TACACGGATAT
TACACGGATAT: ACACGGATATT
ACACGGATATT: CACGGATATTC
CACGGATATTC: ACGGATATTCC
ACGGATATTCC: CGGATATTCCC
CGGATATTCCC: GGATATTCCCA
GGATATTCCCA: GATATTCCCAC
GATATTCCCAC: ATATTCCCACA
ATATTCCCACA: TATTCCCACAA
TATTCCCACAA: ATTCCCACAAA
ATTCCCACAAA: TTCCCACAAAA
TTCCCACAAAA: TCCCACAAAAA
TCCCACAAAAA: CCCACAAAAAT
CCCACAAAAAT: CCACAAAAATA
CCACAAAAATA: CACAAAAATAA
CACAAAAATAA: ACAAAAATAAG
ACAAAAATAAG: CAAAAATAAGG
CAAAAATAAGG: AAAAATAAGGG
AAAAATAAGGG: AAAATAAGGGT
AAAATAAGGGT: AAATAAGGGTT
AAATAAGGGTT: AATAAGGGTTT
AATAAGGGTTT: ATAAGGGTTTC
ATAAGGGTTTC: TAAGGGTTTCA
TAAGGGTTTCA: AAGGGTTTCAA
AAGGGTTTCAA: AGGGTTTCAAA
AGGGTTTCAAA: GGGTTTCAAAG
GGGTTTCAAAG: GGTTTCAAAGT
GGTTTCAAAGT: GTTTCAAAGTT
GTTTCAAAGTT: TTTCAAAGTTC
TTTCAAAGTTC: TTCAAAGTTCT
TTCAAAGTTCT: TCAAAGTTCTG
TCAAAGTTCTG: CAAAGTTCTGC
CAAAGTTCTGC: AAAGTTCTGCG
AAAGTTCTGCG: AAGTTCTGCGG
AAGTTCTGCGG: AGTTCTGCGGG
AGTTCTGCGGG: GTTCTGCGGGA
GTTCTGCGGGA: TTCTGCGGGAT
TTCTGCGGGAT: TCTGCGGGATG
TCTGCGGGATG: CTGCGGGATGA
CTGCGGGATGA: TGCGGGATGAA
TGCGGGATGAA: GCGGGATGAAA
GCGGGATGAAA: CGGGATGAAAA
CGGGATGAAAA: GGGATGAAAAC
GGGATGAAAAC: GGATGAAAACA
GGATGAAAACA: GATGAAAACAG
GATGAAAACAG: ATGAAAACAGA
ATGAAAACAGA: TGAAAACAGAA
TGAAAACAGAA: GAAAACAGAAG
GAAAACAGAAG: AAAACAGAAGC
AAAACAGAAGC: AAACAGAAGCT
AAACAGAAGCT: AACAGAAGCTC
AACAGAAGCTC: ACAGAAGCTCG
ACAGAAGCTCG: CAGAAGCTCGT
CAGAAGCTCGT: AGAAGCTCGTC
AGAAGCTCGTC: GAAGCTCGTCA
GAAGCTCGTCA: AAGCTCGTCAT
AAGCTCGTCAT: AGCTCGTCATG
AGCTCGTCATG: GCTCGTCATGA
GCTCGTCATGA: CTCGTCATGAT
CTCGTCATGAT: TCGTCATGATA
TCGTCATGATA: CGTCATGATAT
CGTCATGATAT: GTCATGATATA
GTCATGATATA: TCATGATATAG
TCATGATATAG: CATGATATAGC
CATGATATAGC: ATGATATAGCC
ATGATATAGCC: TGATATAGCCA
TGATATAGCCA: GATATAGCCAA
GATATAGCCAA: ATATAGCCAAT
ATATAGCCAAT: TATAGCCAATT
TATAGCCAATT: ATAGCCAATTT
ATAGCCAATTT: TAGCCAATTTG
TAGCCAATTTG: AGCCAATTTGT
AGCCAATTTGT: GCCAATTTGTA
GCCAATTTGTA: CCAATTTGTAT
CCAATTTGTAT: CAATTTGTATC
CAATTTGTATC: AATTTGTATCT
AATTTGTATCT: ATTTGTATCTG
ATTTGTATCTG: TTTGTATCTGG
TTTGTATCTGG: TTGTATCTGGA
TTGTATCTGGA: TGTATCTGGAC
TGTATCTGGAC: GTATCTGGACT
GTATCTGGACT: TATCTGGACTG
TATCTGGACTG: ATCTGGACTGG
ATCTGGACTGG: TCTGGACTGGG
TCTGGACTGGG: CTGGACTGGGT
CTGGACTGGGT: TGGACTGGGTG
TGGACTGGGTG: GGACTGGGTGT
GGACTGGGTGT: GACTGGGTGTT
GACTGGGTGTT: ACTGGGTGTTC
ACTGGGTGTTC: CTGGGTGTTCC
CTGGGTGTTCC: TGGGTGTTCCG
TGGGTGTTCCG: GGGTGTTCCGT
GGGTGTTCCGT: GGTGTTCCGTT
GGTGTTCCGTT: GTGTTCCGTTA
GTGTTCCGTTA: TGTTCCGTTAC
TGTTCCGTTAC: GTTCCGTTACA
GTTCCGTTACA: TTCCGTTACAT
TTCCGTTACAT: TCCGTTACATT
TCCGTTACATT: CCGTTACATTG
CCGTTACATTG: CGTTACATTGT
CGTTACATTGT: GTTACATTGTC
GTTACATTGTC: TTACATTGTCT
TTACATTGTCT: TACATTGTCTA
TACATTGTCTA: ACATTGTCTAT
ACATTGTCTAT: CATTGTCTATA
CATTGTCTATA: ATTGTCTATAC
ATTGTCTATAC: TTGTCTATACT
TTGTCTATACT: TGTCTATACTA
TGTCTATACTA: GTCTATACTAA
GTCTATACTAA: TCTATACTAAT
TCTATACTAAT: CTATACTAATG
CTATACTAATG: TATACTAATGG
TATACTAATGG: ATACTAATGGA
ATACTAATGGA: TACTAATGGAG
TACTAATGGAG: ACTAATGGAGG
ACTAATGGAGG: CTAATGGAGGA
CTAATGGAGGA: TAATGGAGGAC
TAATGGAGGAC: AATGGAGGACG
AATGGAGGACG: ATGGAGGACGA
ATGGAGGACGA: TGGAGGACGAA
TGGAGGACGAA: GGAGGACGAAG
GGAGGACGAAG: GAGGACGAAGG
GAGGACGAAGG: AGGACGAAGGG
AGGACGAAGGG: GGACGAAGGGT
GGACGAAGGGT: GACGAAGGGTC
GACGAAGGGTC: ACGAAGGGTCG
ACGAAGGGTCG: CGAAGGGTCGC
CGAAGGGTCGC: GAAGGGTCGCT
GAAGGGTCGCT: AAGGGTCGCTT
AAGGGTCGCTT: AGGGTCGCTTA
AGGGTCGCTTA: GGGTCGCTTAC
GGGTCGCTTAC: GGTCGCTTACT
GGTCGCTTACT: GTCGCTTACTT
GTCGCTTACTT: TCGCTTACTTA
TCGCTTACTTA: CGCTTACTTAC
CGCTTACTTAC: GCTTACTTACG
GCTTACTTACG: CTTACTTACGC
CTTACTTACGC: TTACTTACGCT
TTACTTACGCT: TACTTACGCTT
TACTTACGCTT: ACTTACGCTTC
ACTTACGCTTC: CTTACGCTTCT
CTTACGCTTCT: TTACGCTTCTG
TTACGCTTCTG: TACGCTTCTGC
TACGCTTCTGC: ACGCTTCTGCA
ACGCTTCTGCA: CGCTTCTGCAT
CGCTTCTGCAT: GCTTCTGCATA
GCTTCTGCATA: CTTCTGCATAA
CTTCTGCATAA: TTCTGCATAAG
TTCTGCATAAG: TCTGCATAAGG
TCTGCATAAGG: CTGCATAAGGG
CTGCATAAGGG: TGCATAAGGGT
TGCATAAGGGT: GCATAAGGGTC
GCATAAGGGTC: CATAAGGGTCA
CATAAGGGTCA: ATAAGGGTCAT
ATAAGGGTCAT: TAAGGGTCATA
TAAGGGTCATA: AAGGGTCATAG
AAGGGTCATAG: AGGGTCATAGG
AGGGTCATAGG: GGGTCATAGGG
GGGTCATAGGG: GGTCATAGGGG
GGTCATAGGGG: GTCATAGGGGA
GTCATAGGGGA: TCATAGGGGAT
TCATAGGGGAT: CATAGGGGATG
CATAGGGGATG: ATAGGGGATGG
ATAGGGGATGG: TAGGGGATGGA
TAGGGGATGGA: AGGGGATGGAG
AGGGGATGGAG: GGGGATGGAGT
GGGGATGGAGT: GGGATGGAGTT
GGGATGGAGTT: GGATGGAGTTA
GGATGGAGTTA: GATGGAGTTAT
GATGGAGTTAT: ATGGAGTTATG
ATGGAGTTATG: TGGAGTTATGC
TGGAGTTATGC: GGAGTTATGCG
GGAGTTATGCG: GAGTTATGCGC
GAGTTATGCGC: AGTTATGCGCT
AGTTATGCGCT: GTTATGCGCTA
GTTATGCGCTA: TTATGCGCTAT
TTATGCGCTAT: TATGCGCTATT
TATGCGCTATT: ATGCGCTATTC
ATGCGCTATTC: TGCGCTATTCT
TGCGCTATTCT: GCGCTATTCTA
GCGCTATTCTA: CGCTATTCTAG
CGCTATTCTAG: GCTATTCTAGT
GCTATTCTAGT: CTATTCTAGTG
CTATTCTAGTG: TATTCTAGTGT
TATTCTAGTGT: ATTCTAGTGTA
ATTCTAGTGTA: TTCTAGTGTAA
TTCTAGTGTAA: TCTAGTGTAAC
TCTAGTGTAAC: CTAGTGTAACT
CTAGTGTAACT: TAGTGTAACTT
TAGTGTAACTT: AGTGTAACTTG
AGTGTAACTTG: GTGTAACTTGG
GTGTAACTTGG: TGTAACTTGGT
TGTAACTTGGT: GTAACTTGGTA
GTAACTTGGTA: TAACTTGGTAG
TAACTTGGTAG: AACTTGGTAGA
AACTTGGTAGA: ACTTGGTAGAC
ACTTGGTAGAC: CTTGGTAGACC
CTTGGTAGACC: TTGGTAGACCG
TTGGTAGACCG: TGGTAGACCGC
TGGTAGACCGC: GGTAGACCGCG
GGTAGACCGCG: GTAGACCGCGA
GTAGACCGCGA: TAGACCGCGAG
TAGACCGCGAG: AGACCGCGAGG
AGACCGCGAGG: GACCGCGAGGG
GACCGCGAGGG: ACCGCGAGGGT
ACCGCGAGGGT: CCGCGAGGGTT
CCGCGAGGGTT: CGCGAGGGTTA
CGCGAGGGTTA: GCGAGGGTTAT
GCGAGGGTTAT: CGAGGGTTATG
CGAGGGTTATG: GAGGGTTATGT
GAGGGTTATGT: AGGGTTATGTT
AGGGTTATGTT: GGGTTATGTTG
GGGTTATGTTG: GGTTATGTTGA
GGTTATGTTGA: GTTATGTTGAG
GTTATGTTGAG: TTATGTTGAGG
TTATGTTGAGG: TATGTTGAGGG
TATGTTGAGGG: ATGTTGAGGGT
ATGTTGAGGGT: TGTTGAGGGTC
TGTTGAGGGTC: GTTGAGGGTCG
GTTGAGGGTCG: TTGAGGGTCGT
TTGAGGGTCGT: TGAGGGTCGTT
TGAGGGTCGTT: GAGGGTCGTTA
GAGGGTCGTTA: AGGGTCGTTAG
AGGGTCGTTAG: GGGTCGTTAGA
GGGTCGTTAGA: GGTCGTTAGAT
GGTCGTTAGAT: GTCGTTAGATC
GTCGTTAGATC: TCGTTAGATCG
TCGTTAGATCG: CGTTAGATCGG
CGTTAGATCGG: GTTAGATCGGT
GTTAGATCGGT: TTAGATCGGTC
TTAGATCGGTC: TAGATCGGTCA
TAGATCGGTCA: AGATCGGTCAG
AGATCGGTCAG: GATCGGTCAGC
GATCGGTCAGC: ATCGGTCAGCC
ATCGGTCAGCC: TCGGTCAGCCC
TCGGTCAGCCC: CGGTCAGCCCA
CGGTCAGCCCA: GGTCAGCCCAA
GGTCAGCCCAA: GTCAGCCCAAT
GTCAGCCCAAT: TCAGCCCAATT
TCAGCCCAATT: CAGCCCAATTT
CAGCCCAATTT: AGCCCAATTTG
AGCCCAATTTG: GCCCAATTTGT
GCCCAATTTGT: CCCAATTTGTA
CCCAATTTGTA: CCAATTTGTAG
CCAATTTGTAG: CAATTTGTAGG
CAATTTGTAGG: AATTTGTAGGT
AATTTGTAGGT: ATTTGTAGGTA
ATTTGTAGGTA: TTTGTAGGTAA
TTTGTAGGTAA: TTGTAGGTAAT
TTGTAGGTAAT: TGTAGGTAATC
TGTAGGTAATC: GTAGGTAATCA
GTAGGTAATCA: TAGGTAATCAT
TAGGTAATCAT: AGGTAATCATG
AGGTAATCATG: GGTAATCATGC
GGTAATCATGC: GTAATCATGCT
GTAATCATGCT: TAATCATGCTG
TAATCATGCTG: AATCATGCTGG
AATCATGCTGG: ATCATGCTGGT
ATCATGCTGGT: TCATGCTGGTA
TCATGCTGGTA: CATGCTGGTAA
CATGCTGGTAA: ATGCTGGTAAC
ATGCTGGTAAC: TGCTGGTAACG
TGCTGGTAACG: GCTGGTAACGT
GCTGGTAACGT: CTGGTAACGTA
CTGGTAACGTA: TGGTAACGTAT
TGGTAACGTAT: GGTAACGTATC
GGTAACGTATC: GTAACGTATCA
GTAACGTATCA: TAACGTATCAC
TAACGTATCAC: AACGTATCACG
AACGTATCACG: ACGTATCACGC
ACGTATCACGC: CGTATCACGCT
CGTATCACGCT: GTATCACGCTC
GTATCACGCTC: TATCACGCTCG
TATCACGCTCG: ATCACGCTCGT
ATCACGCTCGT: TCACGCTCGTG
TCACGCTCGTG: CACGCTCGTGC
CACGCTCGTGC: ACGCTCGTGCG
ACGCTCGTGCG: CGCTCGTGCGC
CGCTCGTGCGC: GCTCGTGCGCC
GCTCGTGCGCC: CTCGTGCGCCT
CTCGTGCGCCT: TCGTGCGCCTT
TCGTGCGCCTT: CGTGCGCCTTG
CGTGCGCCTTG: GTGCGCCTTGC
GTGCGCCTTGC: TGCGCCTTGCT
TGCGCCTTGCT: GCGCCTTGCTT
GCGCCTTGCTT: CGCCTTGCTTA
CGCCTTGCTTA: GCCTTGCTTAA
GCCTTGCTTAA: CCTTGCTTAAA
CCTTGCTTAAA: CTTGCTTAAAA
CTTGCTTAAAA: TTGCTTAAAAG
TTGCTTAAAAG: TGCTTAAAAGC
TGCTTAAAAGC: GCTTAAAAGCA
GCTTAAAAGCA: CTTAAAAGCAA
CTTAAAAGCAA: TTAAAAGCAAG
TTAAAAGCAAG: TAAAAGCAAGC
TAAAAGCAAGC: AAAAGCAAGCG
AAAAGCAAGCG: AAAGCAAGCGC
AAAGCAAGCGC: AAGCAAGCGCT
AAGCAAGCGCT: AGCAAGCGCTG
AGCAAGCGCTG: GCAAGCGCTGG
GCAAGCGCTGG: CAAGCGCTGGA
CAAGCGCTGGA: AAGCGCTGGAC
AAGCGCTGGAC: AGCGCTGGACT
AGCGCTGGACT: GCGCTGGACTA
GCGCTGGACTA: CGCTGGACTAG
CGCTGGACTAG: GCTGGACTAGG
GCTGGACTAGG: CTGGACTAGGG
CTGGACTAGGG: TGGACTAGGGG
TGGACTAGGGG: GGACTAGGGGT
GGACTAGGGGT: GACTAGGGGTC
GACTAGGGGTC: ACTAGGGGTCC
ACTAGGGGTCC: CTAGGGGTCCC
CTAGGGGTCCC: TAGGGGTCCCT
TAGGGGTCCCT: AGGGGTCCCTG
AGGGGTCCCTG: GGGGTCCCTGT
GGGGTCCCTGT: GGGTCCCTGTC
GGGTCCCTGTC: GGTCCCTGTCA
GGTCCCTGTCA: GTCCCTGTCAC
GTCCCTGTCAC: TCCCTGTCACG
TCCCTGTCACG: CCCTGTCACGC
CCCTGTCACGC: CCTGTCACGCT
CCTGTCACGCT: CTGTCACGCTG
CTGTCACGCTG: TGTCACGCTGA
TGTCACGCTGA: GTCACGCTGAG
GTCACGCTGAG: TCACGCTGAGG
TCACGCTGAGG: CACGCTGAGGC
CACGCTGAGGC: ACGCTGAGGCA
ACGCTGAGGCA: CGCTGAGGCAA
CGCTGAGGCAA: GCTGAGGCAAC
GCTGAGGCAAC: CTGAGGCAACC
CTGAGGCAACC: TGAGGCAACCA
TGAGGCAACCA: GAGGCAACCAA
GAGGCAACCAA: AGGCAACCAAT
AGGCAACCAAT: GGCAACCAATA
GGCAACCAATA: GCAACCAATAT
GCAACCAATAT: CAACCAATATG
CAACCAATATG: AACCAATATGT
AACCAATATGT: ACCAATATGTA
ACCAATATGTA: CCAATATGTAC
CCAATATGTAC: CAATATGTACA
CAATATGTACA: AATATGTACAT
AATATGTACAT: ATATGTACATA
ATATGTACATA: TATGTACATAC
TATGTACATAC: ATGTACATACG
ATGTACATACG: TGTACATACGT
TGTACATACGT: GTACATACGTA
GTACATACGTA: TACATACGTAA
TACATACGTAA: ACATACGTAAA
ACATACGTAAA: CATACGTAAAA
CATACGTAAAA: ATACGTAAAAC
ATACGTAAAAC: TACGTAAAACG
TACGTAAAACG: ACGTAAAACGA
ACGTAAAACGA: CGTAAAACGAT
CGTAAAACGAT: GTAAAACGATA
GTAAAACGATA: TAAAACGATAA
TAAAACGATAA: AAAACGATAAC
AAAACGATAAC: AAACGATAACG
AAACGATAACG: AACGATAACGG
AACGATAACGG: ACGATAACGGC
ACGATAACGGC: CGATAACGGCC
CGATAACGGCC: GATAACGGCCG
GATAACGGCCG: ATAACGGCCGT
ATAACGGCCGT: TAACGGCCGTA
TAACGGCCGTA: AACGGCCGTAT
AACGGCCGTAT: ACGGCCGTATA
ACGGCCGTATA: CGGCCGTATAT
CGGCCGTATAT: GGCCGTATATC
GGCCGTATATC: GCCGTATATCG
GCCGTATATCG: CCGTATATCGT
CCGTATATCGT: CGTATATCGTT
CGTATATCGTT: GTATATCGTTG
GTATATCGTTG: TATATCGTTGA
TATATCGTTGA: ATATCGTTGAT
ATATCGTTGAT: TATCGTTGATG
TATCGTTGATG: ATCGTTGATGC
ATCGTTGATGC: TCGTTGATGCA
TCGTTGATGCA: CGTTGATGCAC
CGTTGATGCAC: GTTGATGCACT
GTTGATGCACT: TTGATGCACTC
TTGATGCACTC: TGATGCACTCC
TGATGCACTCC: GATGCACTCCT
GATGCACTCCT: ATGCACTCCTA
ATGCACTCCTA: TGCACTCCTAC
TGCACTCCTAC: GCACTCCTACA
GCACTCCTACA: CACTCCTACAT
CACTCCTACAT: ACTCCTACATT
ACTCCTACATT: CTCCTACATTT
CTCCTACATTT: TCCTACATTTT
TCCTACATTTT: CCTACATTTTG
CCTACATTTTG: CTACATTTTGT
CTACATTTTGT: TACATTTTGTC
TACATTTTGTC: ACATTTTGTCC
ACATTTTGTCC: CATTTTGTCCC
CATTTTGTCCC: ATTTTGTCCCG
ATTTTGTCCCG: TTTTGTCCCGA
TTTTGTCCCGA: TTTGTCCCGAT
TTTGTCCCGAT: TTGTCCCGATG
TTGTCCCGATG: TGTCCCGATGA
TGTCCCGATGA: GTCCCGATGAA
GTCCCGATGAA: TCCCGATGAAA
TCCCGATGAAA: CCCGATGAAAA
CCCGATGAAAA: CCGATGAAAAC
CCGATGAAAAC: CGATGAAAACC
CGATGAAAACC: GATGAAAACCT
GATGAAAACCT: ATGAAAACCTC
ATGAAAACCTC: TGAAAACCTCC
TGAAAACCTCC: GAAAACCTCCG
GAAAACCTCCG: AAAACCTCCGG
AAAACCTCCGG: AAACCTCCGGA
AAACCTCCGGA: AACCTCCGGAG
AACCTCCGGAG: ACCTCCGGAGT
ACCTCCGGAGT: CCTCCGGAGTA
CCTCCGGAGTA: CTCCGGAGTAG
CTCCGGAGTAG: TCCGGAGTAGC
TCCGGAGTAGC: CCGGAGTAGCC
CCGGAGTAGCC: CGGAGTAGCCA
CGGAGTAGCCA: GGAGTAGCCAG
GGAGTAGCCAG: GAGTAGCCAGA
GAGTAGCCAGA: AGTAGCCAGAA
AGTAGCCAGAA: GTAGCCAGAAA
GTAGCCAGAAA: TAGCCAGAAAG
TAGCCAGAAAG: AGCCAGAAAGG
AGCCAGAAAGG: GCCAGAAAGGA
GCCAGAAAGGA: CCAGAAAGGAG
CCAGAAAGGAG: CAGAAAGGAGC
CAGAAAGGAGC: AGAAAGGAGCC
AGAAAGGAGCC: GAAAGGAGCCA
GAAAGGAGCCA: AAAGGAGCCAA
AAAGGAGCCAA: AAGGAGCCAAA
AAGGAGCCAAA: AGGAGCCAAAG
AGGAGCCAAAG: GGAGCCAAAGA
GGAGCCAAAGA: GAGCCAAAGAA
GAGCCAAAGAA: AGCCAAAGAAC
AGCCAAAGAAC: GCCAAAGAACA
GCCAAAGAACA: CCAAAGAACAA
CCAAAGAACAA: CAAAGAACAAG
CAAAGAACAAG: AAAGAACAAGA
AAAGAACAAGA: AAGAACAAGAC
AAGAACAAGAC: AGAACAAGACC
AGAACAAGACC: GAACAAGACCT
GAACAAGACCT: AACAAGACCTT
AACAAGACCTT: ACAAGACCTTA
ACAAGACCTTA: CAAGACCTTAC
CAAGACCTTAC: AAGACCTTACA
AAGACCTTACA: AGACCTTACAA
AGACCTTACAA: GACCTTACAAG
GACCTTACAAG: ACCTTACAAGG
ACCTTACAAGG: CCTTACAAGGG
CCTTACAAGGG: CTTACAAGGGG
CTTACAAGGGG: TTACAAGGGGT
TTACAAGGGGT: TACAAGGGGTG
TACAAGGGGTG: ACAAGGGGTGT
ACAAGGGGTGT: CAAGGGGTGTA
CAAGGGGTGTA: AAGGGGTGTAC
AAGGGGTGTAC: AGGGGTGTACG
AGGGGTGTACG: GGGGTGTACGT
GGGGTGTACGT: GGGTGTACGTA
GGGTGTACGTA: GGTGTACGTAC
GGTGTACGTAC: GTGTACGTACG
GTGTACGTACG: TGTACGTACGA
TGTACGTACGA: GTACGTACGAC
GTACGTACGAC: TACGTACGACC
TACGTACGACC: ACGTACGACCT
ACGTACGACCT: CGTACGACCTA
CGTACGACCTA: GTACGACCTAC
GTACGACCTAC: TACGACCTACC
TACGACCTACC: ACGACCTACCT
ACGACCTACCT: CGACCTACCTT
CGACCTACCTT: GACCTACCTTG
GACCTACCTTG: ACCTACCTTGG
ACCTACCTTGG: CCTACCTTGGA
CCTACCTTGGA: CTACCTTGGAT
CTACCTTGGAT: TACCTTGGATA
TACCTTGGATA: ACCTTGGATAG
ACCTTGGATAG: CCTTGGATAGC
CCTTGGATAGC: CTTGGATAGCC
CTTGGATAGCC: TTGGATAGCCC
TTGGATAGCCC: TGGATAGCCCC
TGGATAGCCCC: GGATAGCCCCA
GGATAGCCCCA: GATAGCCCCAG
GATAGCCCCAG: ATAGCCCCAGC
ATAGCCCCAGC: TAGCCCCAGCT
TAGCCCCAGCT: AGCCCCAGCTA
AGCCCCAGCTA: GCCCCAGCTAC
GCCCCAGCTAC: CCCCAGCTACT
CCCCAGCTACT: CCCAGCTACTG
CCCAGCTACTG: CCAGCTACTGA
CCAGCTACTGA: CAGCTACTGAG
CAGCTACTGAG: AGCTACTGAGA
AGCTACTGAGA: GCTACTGAGAT
GCTACTGAGAT: CTACTGAGATC
CTACTGAGATC: TACTGAGATCG
TACTGAGATCG: ACTGAGATCGG
ACTGAGATCGG: CTGAGATCGGT
CTGAGATCGGT: TGAGATCGGTT
TGAGATCGGTT: GAGATCGGTTC
GAGATCGGTTC: AGATCGGTTCA
AGATCGGTTCA: GATCGGTTCAT
GATCGGTTCAT: ATCGGTTCATG
ATCGGTTCATG: TCGGTTCATGC
TCGGTTCATGC: CGGTTCATGCT
CGGTTCATGCT: GGTTCATGCTC
GGTTCATGCTC: GTTCATGCTCA
GTTCATGCTCA: TTCATGCTCAA
TTCATGCTCAA: TCATGCTCAAA
TCATGCTCAAA: CATGCTCAAAA
CATGCTCAAAA: ATGCTCAAAAG
ATGCTCAAAAG: TGCTCAAAAGC
TGCTCAAAAGC: GCTCAAAAGCC
GCTCAAAAGCC: CTCAAAAGCCG
CTCAAAAGCCG: TCAAAAGCCGA
TCAAAAGCCGA: CAAAAGCCGAT
CAAAAGCCGAT: AAAAGCCGATG
AAAAGCCGATG: AAAGCCGATGA
AAAGCCGATGA: AAGCCGATGAT
AAGCCGATGAT: AGCCGATGATC
AGCCGATGATC: GCCGATGATCT
GCCGATGATCT: CCGATGATCTC
CCGATGATCTC: CGATGATCTCT
CGATGATCTCT: GATGATCTCTA
GATGATCTCTA: ATGATCTCTAC
ATGATCTCTAC: TGATCTCTACC
TGATCTCTACC: GATCTCTACCT
GATCTCTACCT: ATCTCTACCTA
ATCTCTACCTA: TCTCTACCTAG
TCTCTACCTAG: CTCTACCTAGC
CTCTACCTAGC: TCTACCTAGCC
TCTACCTAGCC: CTACCTAGCCG
CTACCTAGCCG: TACCTAGCCGC
TACCTAGCCGC: ACCTAGCCGCG
ACCTAGCCGCG: CCTAGCCGCGG
CCTAGCCGCGG: CTAGCCGCGGT
CTAGCCGCGGT: TAGCCGCGGTG
TAGCCGCGGTG: AGCCGCGGTGG
AGCCGCGGTGG: GCCGCGGTGGG
GCCGCGGTGGG: CCGCGGTGGGT
CCGCGGTGGGT: CGCGGTGGGTC
CGCGGTGGGTC: GCGGTGGGTCC
GCGGTGGGTCC: CGGTGGGTCCA
CGGTGGGTCCA: GGTGGGTCCAT
GGTGGGTCCAT: GTGGGTCCATT
GTGGGTCCATT: TGGGTCCATTT
TGGGTCCATTT: GGGTCCATTTT
GGGTCCATTTT: GGTCCATTTTA
GGTCCATTTTA: GTCCATTTTAA
GTCCATTTTAA: TCCATTTTAAA
TCCATTTTAAA: CCATTTTAAAA
CCATTTTAAAA: CATTTTAAAAA
CATTTTAAAAA: ATTTTAAAAAA
ATTTTAAAAAA: TTTTAAAAAAG
TTTTAAAAAAG: TTTAAAAAAGC
TTTAAAAAAGC: TTAAAAAAGCA
TTAAAAAAGCA: TAAAAAAGCAA
TAAAAAAGCAA: AAAAAAGCAAC
AAAAAAGCAAC: AAAAAGCAACC
AAAAAGCAACC: AAAAGCAACCT
AAAAGCAACCT: AAAGCAACCTT
AAAGCAACCTT: AAGCAACCTTT
AAGCAACCTTT: AGCAACCTTTG
AGCAACCTTTG: GCAACCTTTGA
GCAACCTTTGA: CAACCTTTGAA
CAACCTTTGAA: AACCTTTGAAG
AACCTTTGAAG: ACCTTTGAAGC
ACCTTTGAAGC: CCTTTGAAGCC
CCTTTGAAGCC: CTTTGAAGCCA
CTTTGAAGCCA: TTTGAAGCCAC
TTTGAAGCCAC: TTGAAGCCACA
TTGAAGCCACA: TGAAGCCACAG
TGAAGCCACAG: GAAGCCACAGT
GAAGCCACAGT: AAGCCACAGTC
AAGCCACAGTC: AGCCACAGTCA
AGCCACAGTCA: GCCACAGTCAG
GCCACAGTCAG: CCACAGTCAGG
CCACAGTCAGG: CACAGTCAGGT
CACAGTCAGGT: ACAGTCAGGTA
ACAGTCAGGTA: CAGTCAGGTAG
CAGTCAGGTAG: AGTCAGGTAGC
AGTCAGGTAGC: GTCAGGTAGCG
GTCAGGTAGCG: TCAGGTAGCGT
TCAGGTAGCGT: CAGGTAGCGTT
CAGGTAGCGTT: AGGTAGCGTTC
AGGTAGCGTTC: GGTAGCGTTCT
GGTAGCGTTCT: GTAGCGTTCTT
GTAGCGTTCTT: TAGCGTTCTTG
TAGCGTTCTTG: AGCGTTCTTGC
AGCGTTCTTGC: GCGTTCTTGCG
GCGTTCTTGCG: CGTTCTTGCGT
CGTTCTTGCGT: GTTCTTGCGTA
GTTCTTGCGTA: TTCTTGCGTAG
TTCTTGCGTAG: TCTTGCGTAGA
TCTTGCGTAGA: CTTGCGTAGAG
CTTGCGTAGAG: TTGCGTAGAGT
TTGCGTAGAGT: TGCGTAGAGTA
TGCGTAGAGTA: GCGTAGAGTAT
GCGTAGAGTAT: CGTAGAGTATC
CGTAGAGTATC: GTAGAGTATCT
GTAGAGTATCT: TAGAGTATCTC
TAGAGTATCTC: AGAGTATCTCG
AGAGTATCTCG: GAGTATCTCGT
GAGTATCTCGT: AGTATCTCGTC
AGTATCTCGTC: GTATCTCGTCT
GTATCTCGTCT: TATCTCGTCTT
TATCTCGTCTT: ATCTCGTCTTC
ATCTCGTCTTC: TCTCGTCTTCA
TCTCGTCTTCA: CTCGTCTTCAT
CTCGTCTTCAT: TCGTCTTCATC
TCGTCTTCATC: CGTCTTCATCA
CGTCTTCATCA: GTCTTCATCAT
GTCTTCATCAT: TCTTCATCATG
TCTTCATCATG: CTTCATCATGT
CTTCATCATGT: TTCATCATGTA
TTCATCATGTA: TCATCATGTAG
TCATCATGTAG: CATCATGTAGG
CATCATGTAGG: ATCATGTAGGG
ATCATGTAGGG: TCATGTAGGGG
TCATGTAGGGG: CATGTAGGGGT
CATGTAGGGGT: ATGTAGGGGTG
ATGTAGGGGTG: TGTAGGGGTGT
TGTAGGGGTGT: GTAGGGGTGTT
GTAGGGGTGTT: TAGGGGTGTTA
TAGGGGTGTTA: AGGGGTGTTAT
AGGGGTGTTAT: GGGGTGTTATA
GGGGTGTTATA: GGGTGTTATAT
GGGTGTTATAT: GGTGTTATATT
GGTGTTATATT: GTGTTATATTG
GTGTTATATTG: TGTTATATTGA
TGTTATATTGA: GTTATATTGAC
GTTATATTGAC: TTATATTGACG
TTATATTGACG: TATATTGACGG
TATATTGACGG: ATATTGACGGC
ATATTGACGGC: TATTGACGGCA
TATTGACGGCA: ATTGACGGCAA
ATTGACGGCAA: TTGACGGCAAG
TTGACGGCAAG: TGACGGCAAGA
TGACGGCAAGA: GACGGCAAGAA
GACGGCAAGAA: ACGGCAAGAAT
ACGGCAAGAAT: CGGCAAGAATG
CGGCAAGAATG: GGCAAGAATGT
GGCAAGAATGT: GCAAGAATGTC
GCAAGAATGTC: CAAGAATGTCT
CAAGAATGTCT: AAGAATGTCTT
AAGAATGTCTT: AGAATGTCTTT
AGAATGTCTTT: GAATGTCTTTG
GAATGTCTTTG: AATGTCTTTGC
AATGTCTTTGC: ATGTCTTTGCT
ATGTCTTTGCT: TGTCTTTGCTA
TGTCTTTGCTA: GTCTTTGCTAA
GTCTTTGCTAA: TCTTTGCTAAA
TCTTTGCTAAA: CTTTGCTAAAT
CTTTGCTAAAT: TTTGCTAAATC
TTTGCTAAATC: TTGCTAAATCG
TTGCTAAATCG: TGCTAAATCGG
TGCTAAATCGG: GCTAAATCGGA
GCTAAATCGGA: CTAAATCGGAA
CTAAATCGGAA: TAAATCGGAAA
AAATCGGAAAA: AATCGGAAAAA
AATCGGAAAAA: ATCGGAAAAAT
ATCGGAAAAAT: TCGGAAAAATT
TCGGAAAAATT: CGGAAAAATTG
CGGAAAAATTG: GGAAAAATTGC
GGAAAAATTGC: GAAAAATTGCC
GAAAAATTGCC: AAAAATTGCCG
AAAAATTGCCG: AAAATTGCCGT
AAAATTGCCGT: AAATTGCCGTC
AAATTGCCGTC: AATTGCCGTCG
AATTGCCGTCG: ATTGCCGTCGC
ATTGCCGTCGC: TTGCCGTCGCT
TTGCCGTCGCT: TGCCGTCGCTG
TGCCGTCGCTG: GCCGTCGCTGG
GCCGTCGCTGG: CCGTCGCTGGA
CCGTCGCTGGA: CGTCGCTGGAT
CGTCGCTGGAT: GTCGCTGGATA
GTCGCTGGATA: TCGCTGGATAC
TCGCTGGATAC: CGCTGGATACA
CGCTGGATACA: GCTGGATACAT
GCTGGATACAT: CTGGATACATG
CTGGATACATG: TGGATACATGA
TGGATACATGA: GGATACATGAA
GGATACATGAA: GATACATGAAT
GATACATGAAT: ATACATGAATA
ATACATGAATA: TACATGAATAA
TACATGAATAA: ACATGAATAAC
ACATGAATAAC: CATGAATAACG
CATGAATAACG: ATGAATAACGC
ATGAATAACGC: TGAATAACGCA
TGAATAACGCA: GAATAACGCAG
GAATAACGCAG: AATAACGCAGT
AATAACGCAGT: ATAACGCAGTG
ATAACGCAGTG: TAACGCAGTGG
TAACGCAGTGG: AACGCAGTGGT
AACGCAGTGGT: ACGCAGTGGTG
ACGCAGTGGTG: CGCAGTGGTGA
CGCAGTGGTGA: GCAGTGGTGAG
GCAGTGGTGAG: CAGTGGTGAGG
CAGTGGTGAGG: AGTGGTGAGGC
AGTGGTGAGGC: GTGGTGAGGCT
GTGGTGAGGCT: TGGTGAGGCTC
TGGTGAGGCTC: GGTGAGGCTCA
GGTGAGGCTCA: GTGAGGCTCAA
GTGAGGCTCAA: TGAGGCTCAAA
TGAGGCTCAAA: GAGGCTCAAAC
GAGGCTCAAAC: AGGCTCAAACG
AGGCTCAAACG: GGCTCAAACGA
GGCTCAAACGA: GCTCAAACGAT
GCTCAAACGAT: CTCAAACGATT
CTCAAACGATT: TCAAACGATTG
TCAAACGATTG: CAAACGATTGT
CAAACGATTGT: AAACGATTGTA
AAACGATTGTA: AACGATTGTAA
AACGATTGTAA: ACGATTGTAAG
ACGATTGTAAG: CGATTGTAAGT
CGATTGTAAGT: GATTGTAAGTC
GATTGTAAGTC: ATTGTAAGTCT
ATTGTAAGTCT: TTGTAAGTCTG
TTGTAAGTCTG: TGTAAGTCTGA
TGTAAGTCTGA: GTAAGTCTGAC
GTAAGTCTGAC: TAAGTCTGACC
TAAGTCTGACC: AAGTCTGACCG
AAGTCTGACCG: AGTCTGACCGG
AGTCTGACCGG: GTCTGACCGGC
GTCTGACCGGC: TCTGACCGGCG
TCTGACCGGCG: CTGACCGGCGG
CTGACCGGCGG: TGACCGGCGGC
TGACCGGCGGC: GACCGGCGGCA
GACCGGCGGCA: ACCGGCGGCAA
ACCGGCGGCAA: CCGGCGGCAAT
CCGGCGGCAAT: CGGCGGCAATA
CGGCGGCAATA: GGCGGCAATAA
GGCGGCAATAA: GCGGCAATAAG
GCGGCAATAAG: CGGCAATAAGC
CGGCAATAAGC: GGCAATAAGCT
GGCAATAAGCT: GCAATAAGCTT
GCAATAAGCTT: CAATAAGCTTA
CAATAAGCTTA: AATAAGCTTAT
AATAAGCTTAT: ATAAGCTTATT
ATAAGCTTATT: TAAGCTTATTG
TAAGCTTATTG: AAGCTTATTGT
AAGCTTATTGT: AGCTTATTGTC
AGCTTATTGTC: GCTTATTGTCC
GCTTATTGTCC: CTTATTGTCCA
CTTATTGTCCA: TTATTGTCCAC
TTATTGTCCAC: TATTGTCCACT
TATTGTCCACT: ATTGTCCACTC
ATTGTCCACTC: TTGTCCACTCG
TTGTCCACTCG: TGTCCACTCGT
TGTCCACTCGT: GTCCACTCGTT
GTCCACTCGTT: TCCACTCGTTA
TCCACTCGTTA: CCACTCGTTAG
CCACTCGTTAG: CACTCGTTAGT
CACTCGTTAGT: ACTCGTTAGTT
ACTCGTTAGTT: CTCGTTAGTTG
CTCGTTAGTTG: TCGTTAGTTGC
TCGTTAGTTGC: CGTTAGTTGCG
CGTTAGTTGCG: GTTAGTTGCGA
GTTAGTTGCGA: TTAGTTGCGAG
TTAGTTGCGAG: TAGTTGCGAGA
TAGTTGCGAGA: AGTTGCGAGAG
AGTTGCGAGAG: GTTGCGAGAGT
GTTGCGAGAGT: TTGCGAGAGTG
TTGCGAGAGTG: TGCGAGAGTGC
TGCGAGAGTGC: GCGAGAGTGCT
GCGAGAGTGCT: CGAGAGTGCTT
CGAGAGTGCTT: GAGAGTGCTTG
GAGAGTGCTTG: AGAGTGCTTGG
AGAGTGCTTGG: GAGTGCTTGGC
GAGTGCTTGGC: AGTGCTTGGCG
AGTGCTTGGCG: GTGCTTGGCGT
GTGCTTGGCGT: TGCTTGGCGTT
TGCTTGGCGTT: GCTTGGCGTTA
GCTTGGCGTTA: CTTGGCGTTAC
CTTGGCGTTAC: TTGGCGTTACG
TTGGCGTTACG: TGGCGTTACGC
TGGCGTTACGC: GGCGTTACGCT
GGCGTTACGCT: GCGTTACGCTG
GCGTTACGCTG: CGTTACGCTGG
CGTTACGCTGG: GTTACGCTGGG
GTTACGCTGGG: TTACGCTGGGC
TTACGCTGGGC: TACGCTGGGCG
TACGCTGGGCG: ACGCTGGGCGG
ACGCTGGGCGG: CGCTGGGCGGG
CGCTGGGCGGG: GCTGGGCGGGT
GCTGGGCGGGT: CTGGGCGGGTT
CTGGGCGGGTT: TGGGCGGGTTG
TGGGCGGGTTG: GGGCGGGTTGC
GGGCGGGTTGC: GGCGGGTTGCA
GGCGGGTTGCA: GCGGGTTGCAG
GCGGGTTGCAG: CGGGTTGCAGC
CGGGTTGCAGC: GGGTTGCAGCC
GGGTTGCAGCC: GGTTGCAGCCA
GGTTGCAGCCA: GTTGCAGCCAG
GTTGCAGCCAG: TTGCAGCCAGG
TTGCAGCCAGG: TGCAGCCAGGC
TGCAGCCAGGC: GCAGCCAGGCT
GCAGCCAGGCT: CAGCCAGGCTC
CAGCCAGGCTC: AGCCAGGCTCG
AGCCAGGCTCG: GCCAGGCTCGA
GCCAGGCTCGA: CCAGGCTCGAA
CCAGGCTCGAA: CAGGCTCGAAG
CAGGCTCGAAG: AGGCTCGAAGG
AGGCTCGAAGG: GGCTCGAAGGT
GGCTCGAAGGT: GCTCGAAGGTT
GCTCGAAGGTT: CTCGAAGGTTA
CTCGAAGGTTA: TCGAAGGTTAA
TCGAAGGTTAA: CGAAGGTTAAT
CGAAGGTTAAT: GAAGGTTAATG
GAAGGTTAATG: AAGGTTAATGA
AAGGTTAATGA: AGGTTAATGAA
AGGTTAATGAA: GGTTAATGAAA
GGTTAATGAAA: GTTAATGAAAC
GTTAATGAAAC: TTAATGAAACC
TTAATGAAACC: TAATGAAACCT
TAATGAAACCT: AATGAAACCTT
AATGAAACCTT: ATGAAACCTTC
ATGAAACCTTC: TGAAACCTTCG
TGAAACCTTCG: GAAACCTTCGT
GAAACCTTCGT: AAACCTTCGTG
AAACCTTCGTG: AACCTTCGTGA
AACCTTCGTGA: ACCTTCGTGAT
ACCTTCGTGAT: CCTTCGTGATC
CCTTCGTGATC: CTTCGTGATCC
CTTCGTGATCC: TTCGTGATCCA
TTCGTGATCCA: TCGTGATCCAC
TCGTGATCCAC: CGTGATCCACT
CGTGATCCACT: GTGATCCACTG
GTGATCCACTG: TGATCCACTGG
TGATCCACTGG: GATCCACTGGA
GATCCACTGGA: ATCCACTGGAG
ATCCACTGGAG: TCCACTGGAGA
TCCACTGGAGA: CCACTGGAGAC
CCACTGGAGAC: CACTGGAGACG
CACTGGAGACG: ACTGGAGACGA
ACTGGAGACGA: CTGGAGACGAG
CTGGAGACGAG: TGGAGACGAGA
TGGAGACGAGA: GGAGACGAGAA
GGAGACGAGAA: GAGACGAGAAA
GAGACGAGAAA: AGACGAGAAAA
AGACGAGAAAA: GACGAGAAAAA
GACGAGAAAAA: ACGAGAAAAAG
ACGAGAAAAAG: CGAGAAAAAGA
CGAGAAAAAGA: GAGAAAAAGAT
GAGAAAAAGAT: AGAAAAAGATT
AGAAAAAGATT: GAAAAAGATTA
GAAAAAGATTA: AAAAAGATTAA
AAAAAGATTAA: AAAAGATTAAA
AAAAGATTAAA: AAAGATTAAAC
AAAGATTAAAC: AAGATTAAACA
AAGATTAAACA: AGATTAAACAG
AGATTAAACAG: GATTAAACAGG
GATTAAACAGG: ATTAAACAGGC
ATTAAACAGGC: TTAAACAGGCA
TTAAACAGGCA: TAAACAGGCAA
TAAACAGGCAA: AAACAGGCAAA
AAACAGGCAAA: AACAGGCAAAG
AACAGGCAAAG: ACAGGCAAAGA
ACAGGCAAAGA: CAGGCAAAGAT
CAGGCAAAGAT: AGGCAAAGATA
AGGCAAAGATA: GGCAAAGATAT
GGCAAAGATAT: GCAAAGATATT
GCAAAGATATT: CAAAGATATTT
CAAAGATATTT: AAAGATATTTG
AAAGATATTTG: AAGATATTTGC
AAGATATTTGC: AGATATTTGCC
AGATATTTGCC: GATATTTGCCC
GATATTTGCCC: ATATTTGCCCC
ATATTTGCCCC: TATTTGCCCCC
TATTTGCCCCC: ATTTGCCCCCT
ATTTGCCCCCT: TTTGCCCCCTA
TTTGCCCCCTA: TTGCCCCCTAC
TTGCCCCCTAC: TGCCCCCTACT
TGCCCCCTACT: GCCCCCTACTG
GCCCCCTACTG: CCCCCTACTGG
CCCCCTACTGG: CCCCTACTGGA
CCCCTACTGGA: CCCTACTGGAG
CCCTACTGGAG: CCTACTGGAGT
CCTACTGGAGT: CTACTGGAGTT
CTACTGGAGTT: TACTGGAGTTC
TACTGGAGTTC: ACTGGAGTTCA
ACTGGAGTTCA: CTGGAGTTCAC
CTGGAGTTCAC: TGGAGTTCACT
TGGAGTTCACT: GGAGTTCACTG
GGAGTTCACTG: GAGTTCACTGG
GAGTTCACTGG: AGTTCACTGGG
AGTTCACTGGG: GTTCACTGGGT
GTTCACTGGGT: TTCACTGGGTC
TTCACTGGGTC: TCACTGGGTCA
TCACTGGGTCA: CACTGGGTCAG
CACTGGGTCAG: ACTGGGTCAGA
ACTGGGTCAGA: CTGGGTCAGAT
CTGGGTCAGAT: TGGGTCAGATG
TGGGTCAGATG: GGGTCAGATGA
GGGTCAGATGA: GGTCAGATGAT
GGTCAGATGAT: GTCAGATGATG
GTCAGATGATG: TCAGATGATGG
TCAGATGATGG: CAGATGATGGT
CAGATGATGGT: AGATGATGGTA
AGATGATGGTA: GATGATGGTAA
GATGATGGTAA: ATGATGGTAAT
ATGATGGTAAT: TGATGGTAATA
TGATGGTAATA: GATGGTAATAA
GATGGTAATAA: ATGGTAATAAA
ATGGTAATAAA: TGGTAATAAAA
TGGTAATAAAA: GGTAATAAAAT
GGTAATAAAAT: GTAATAAAATT
GTAATAAAATT: TAATAAAATTT
TAATAAAATTT: AATAAAATTTA
AATAAAATTTA: ATAAAATTTAC
ATAAAATTTAC: TAAAATTTACC
TAAAATTTACC: AAAATTTACCA
AAAATTTACCA: AAATTTACCAT
AAATTTACCAT: AATTTACCATG
AATTTACCATG: ATTTACCATGC
ATTTACCATGC: TTTACCATGCA
TTTACCATGCA: TTACCATGCAC
TTACCATGCAC: TACCATGCACA
TACCATGCACA: ACCATGCACAC
ACCATGCACAC: CCATGCACACA
CCATGCACACA: CATGCACACAG
CATGCACACAG: ATGCACACAGT
ATGCACACAGT: TGCACACAGTT
TGCACACAGTT: GCACACAGTTT
GCACACAGTTT: CACACAGTTTA
CACACAGTTTA: ACACAGTTTAA
ACACAGTTTAA: CACAGTTTAAT
CACAGTTTAAT: ACAGTTTAATA
ACAGTTTAATA: CAGTTTAATAT
CAGTTTAATAT: AGTTTAATATA
AGTTTAATATA: GTTTAATATAT
GTTTAATATAT: TTTAATATATA
TTTAATATATA: TTAATATATAC
TTAATATATAC: TAATATATACT
TAATATATACT: AATATATACTT
AATATATACTT: ATATATACTTA
ATATATACTTA: TATATACTTAA
TATATACTTAA: ATATACTTAAT
ATATACTTAAT: TATACTTAATA
TATACTTAATA: ATACTTAATAG
ATACTTAATAG: TACTTAATAGG
TACTTAATAGG: ACTTAATAGGT
ACTTAATAGGT: CTTAATAGGTT
CTTAATAGGTT: TTAATAGGTTA
TTAATAGGTTA: TAATAGGTTAA
TAATAGGTTAA: AATAGGTTAAG
AATAGGTTAAG: ATAGGTTAAGC
ATAGGTTAAGC: TAGGTTAAGCA
TAGGTTAAGCA: AGGTTAAGCAA
AGGTTAAGCAA: GGTTAAGCAAG
GGTTAAGCAAG: GTTAAGCAAGG
GTTAAGCAAGG: TTAAGCAAGGA
TTAAGCAAGGA: TAAGCAAGGAC
TAAGCAAGGAC: AAGCAAGGACA
AAGCAAGGACA: AGCAAGGACAT
AGCAAGGACAT: GCAAGGACATT
GCAAGGACATT: CAAGGACATTA
CAAGGACATTA: AAGGACATTAC
AAGGACATTAC: AGGACATTACC
AGGACATTACC: GGACATTACCG
GGACATTACCG: GACATTACCGT
GACATTACCGT: ACATTACCGTC
ACATTACCGTC: CATTACCGTCA
CATTACCGTCA: ATTACCGTCAC
ATTACCGTCAC: TTACCGTCACA
TTACCGTCACA: TACCGTCACAA
TACCGTCACAA: ACCGTCACAAT
ACCGTCACAAT: CCGTCACAATC
CCGTCACAATC: CGTCACAATCA
CGTCACAATCA: GTCACAATCAG
GTCACAATCAG: TCACAATCAGT
TCACAATCAGT: CACAATCAGTA
CACAATCAGTA: ACAATCAGTAA
ACAATCAGTAA: CAATCAGTAAT
CAATCAGTAAT: AATCAGTAATT
AATCAGTAATT: ATCAGTAATTA
ATCAGTAATTA: TCAGTAATTAA
TCAGTAATTAA: CAGTAATTAAT
CAGTAATTAAT: AGTAATTAATA
AGTAATTAATA: GTAATTAATAG
GTAATTAATAG: TAATTAATAGC
TAATTAATAGC: AATTAATAGCG
AATTAATAGCG: ATTAATAGCGT
ATTAATAGCGT: TTAATAGCGTC
TTAATAGCGTC: TAATAGCGTCC
TAATAGCGTCC: AATAGCGTCCC
AATAGCGTCCC: ATAGCGTCCCT
ATAGCGTCCCT: TAGCGTCCCTT
TAGCGTCCCTT: AGCGTCCCTTG
AGCGTCCCTTG: GCGTCCCTTGA
GCGTCCCTTGA: CGTCCCTTGAC
CGTCCCTTGAC: GTCCCTTGACA
GTCCCTTGACA: TCCCTTGACAG
TCCCTTGACAG: CCCTTGACAGC
CCCTTGACAGC: CCTTGACAGCT
CCTTGACAGCT: CTTGACAGCTT
CTTGACAGCTT: TTGACAGCTTC
TTGACAGCTTC: TGACAGCTTCG
TGACAGCTTCG: GACAGCTTCGG
GACAGCTTCGG: ACAGCTTCGGT
ACAGCTTCGGT: CAGCTTCGGTC
CAGCTTCGGTC: AGCTTCGGTCG
AGCTTCGGTCG: GCTTCGGTCGG
GCTTCGGTCGG: CTTCGGTCGGC
CTTCGGTCGGC: TTCGGTCGGCG
TTCGGTCGGCG: TCGGTCGGCGC
TCGGTCGGCGC: CGGTCGGCGCG
CGGTCGGCGCG: GGTCGGCGCGG
GGTCGGCGCGG: GTCGGCGCGGA
GTCGGCGCGGA: TCGGCGCGGAC
TCGGCGCGGAC: CGGCGCGGACC
CGGCGCGGACC: GGCGCGGACCC
GGCGCGGACCC: GCGCGGACCCC
GCGCGGACCCC: CGCGGACCCCA
CGCGGACCCCA: GCGGACCCCAC
GCGGACCCCAC: CGGACCCCACA
CGGACCCCACA: GGACCCCACAT
GGACCCCACAT: GACCCCACATC
GACCCCACATC: ACCCCACATCA
ACCCCACATCA: CCCCACATCAT
CCCCACATCAT: CCCACATCATT
CCCACATCATT: CCACATCATTG
CCACATCATTG: CACATCATTGA
CACATCATTGA: ACATCATTGAT
ACATCATTGAT: CATCATTGATA
CATCATTGATA: ATCATTGATAA
ATCATTGATAA: TCATTGATAAA
TCATTGATAAA: CATTGATAAAT
CATTGATAAAT: ATTGATAAATC
ATTGATAAATC: TTGATAAATCT
TTGATAAATCT: TGATAAATCTT
TGATAAATCTT: GATAAATCTTG
GATAAATCTTG: ATAAATCTTGA
ATAAATCTTGA: TAAATCTTGAT
TAAATCTTGAT: AAATCTTGATC
AAATCTTGATC: AATCTTGATCC
AATCTTGATCC: ATCTTGATCCA
ATCTTGATCCA: TCTTGATCCAA
TCTTGATCCAA: CTTGATCCAAA
CTTGATCCAAA: TTGATCCAAAG
TTGATCCAAAG: TGATCCAAAGG
TGATCCAAAGG: GATCCAAAGGG
GATCCAAAGGG: ATCCAAAGGGC
ATCCAAAGGGC: TCCAAAGGGCT
TCCAAAGGGCT: CCAAAGGGCTT
CCAAAGGGCTT: CAAAGGGCTTC
CAAAGGGCTTC: AAAGGGCTTCC
AAAGGGCTTCC: AAGGGCTTCCT
AAGGGCTTCCT: AGGGCTTCCTC
AGGGCTTCCTC: GGGCTTCCTCC
GGGCTTCCTCC: GGCTTCCTCCA
GGCTTCCTCCA: GCTTCCTCCAA
GCTTCCTCCAA: CTTCCTCCAAA
CTTCCTCCAAA: TTCCTCCAAAG
TTCCTCCAAAG: TCCTCCAAAGG
TCCTCCAAAGG: CCTCCAAAGGG
CCTCCAAAGGG: CTCCAAAGGGT
CTCCAAAGGGT: TCCAAAGGGTC
TCCAAAGGGTC: CCAAAGGGTCT
CCAAAGGGTCT: CAAAGGGTCTC
CAAAGGGTCTC: AAAGGGTCTCT
AAAGGGTCTCT: AAGGGTCTCTG
AAGGGTCTCTG: AGGGTCTCTGG
AGGGTCTCTGG: GGGTCTCTGGG
GGGTCTCTGGG: GGTCTCTGGGT
GGTCTCTGGGT: GTCTCTGGGTT
GTCTCTGGGTT: TCTCTGGGTTC
TCTCTGGGTTC: CTCTGGGTTCT
CTCTGGGTTCT: TCTGGGTTCTT
TCTGGGTTCTT: CTGGGTTCTTT
CTGGGTTCTTT: TGGGTTCTTTC
TGGGTTCTTTC: GGGTTCTTTCT
GGGTTCTTTCT: GGTTCTTTCTT
GGTTCTTTCTT: GTTCTTTCTTC
GTTCTTTCTTC: TTCTTTCTTCT
TTCTTTCTTCT: TCTTTCTTCTA
TCTTTCTTCTA: CTTTCTTCTAT
CTTTCTTCTAT: TTTCTTCTATG
TTTCTTCTATG: TTCTTCTATGC
TTCTTCTATGC: TCTTCTATGCG
TCTTCTATGCG: CTTCTATGCGT
CTTCTATGCGT: TTCTATGCGTA
TTCTATGCGTA: TCTATGCGTAG
TCTATGCGTAG: CTATGCGTAGG
CTATGCGTAGG: TATGCGTAGGC
TATGCGTAGGC: ATGCGTAGGCA
ATGCGTAGGCA: TGCGTAGGCAG
TGCGTAGGCAG: GCGTAGGCAGA
GCGTAGGCAGA: CGTAGGCAGAA
CGTAGGCAGAA: GTAGGCAGAAC
GTAGGCAGAAC: TAGGCAGAACA
TAGGCAGAACA: AGGCAGAACAG
AGGCAGAACAG: GGCAGAACAGG
GGCAGAACAGG: GCAGAACAGGA
GCAGAACAGGA: CAGAACAGGAT
CAGAACAGGAT: AGAACAGGATA
AGAACAGGATA: GAACAGGATAT
GAACAGGATAT: AACAGGATATG
AACAGGATATG: ACAGGATATGC
ACAGGATATGC: CAGGATATGCT
CAGGATATGCT: AGGATATGCTT
AGGATATGCTT: GGATATGCTTA
GGATATGCTTA: GATATGCTTAA
GATATGCTTAA: ATATGCTTAAC
ATATGCTTAAC: TATGCTTAACG
TATGCTTAACG: ATGCTTAACGA
ATGCTTAACGA: TGCTTAACGAA
TGCTTAACGAA: GCTTAACGAAG
GCTTAACGAAG: CTTAACGAAGT
CTTAACGAAGT: TTAACGAAGTA
TTAACGAAGTA: TAACGAAGTAT
TAACGAAGTAT: AACGAAGTATC
AACGAAGTATC: ACGAAGTATCC
ACGAAGTATCC: CGAAGTATCCA
CGAAGTATCCA: GAAGTATCCAT
GAAGTATCCAT: AAGTATCCATT
AAGTATCCATT: AGTATCCATTT
AGTATCCATTT: GTATCCATTTT
GTATCCATTTT: TATCCATTTTG
TATCCATTTTG: ATCCATTTTGG
ATCCATTTTGG: TCCATTTTGGA
TCCATTTTGGA: CCATTTTGGAT
CCATTTTGGAT: CATTTTGGATC
CATTTTGGATC: ATTTTGGATCA
ATTTTGGATCA: TTTTGGATCAA
TTTTGGATCAA: TTTGGATCAAC
TTTGGATCAAC: TTGGATCAACC
TTGGATCAACC: TGGATCAACCG
TGGATCAACCG: GGATCAACCGA
GGATCAACCGA: GATCAACCGAC
GATCAACCGAC: ATCAACCGACT
ATCAACCGACT: TCAACCGACTT
TCAACCGACTT: CAACCGACTTT
CAACCGACTTT: AACCGACTTTA
AACCGACTTTA: ACCGACTTTAA
ACCGACTTTAA: CCGACTTTAAG
CCGACTTTAAG: CGACTTTAAGG
CGACTTTAAGG: GACTTTAAGGT
GACTTTAAGGT: ACTTTAAGGTT
ACTTTAAGGTT: CTTTAAGGTTT
CTTTAAGGTTT: TTTAAGGTTTA
TTTAAGGTTTA: TTAAGGTTTAT
TTAAGGTTTAT: TAAGGTTTATC
TAAGGTTTATC: AAGGTTTATCT
AAGGTTTATCT: AGGTTTATCTT
AGGTTTATCTT: GGTTTATCTTG
GGTTTATCTTG: GTTTATCTTGA
GTTTATCTTGA: TTTATCTTGAG
TTTATCTTGAG: TTATCTTGAGC
TTATCTTGAGC: TATCTTGAGCG
TATCTTGAGCG: ATCTTGAGCGT
ATCTTGAGCGT: TCTTGAGCGTG
TCTTGAGCGTG: CTTGAGCGTGC
CTTGAGCGTGC: TTGAGCGTGCG
TTGAGCGTGCG: TGAGCGTGCGT
TGAGCGTGCGT: GAGCGTGCGTA
GAGCGTGCGTA: AGCGTGCGTAC
AGCGTGCGTAC: GCGTGCGTACT
GCGTGCGTACT: CGTGCGTACTG
CGTGCGTACTG: GTGCGTACTGC
GTGCGTACTGC: TGCGTACTGCG
TGCGTACTGCG: GCGTACTGCGA
GCGTACTGCGA: CGTACTGCGAA
CGTACTGCGAA: GTACTGCGAAG
GTACTGCGAAG: TACTGCGAAGG
TACTGCGAAGG: ACTGCGAAGGG
ACTGCGAAGGG: CTGCGAAGGGC
CTGCGAAGGGC: TGCGAAGGGCC
TGCGAAGGGCC: GCGAAGGGCCA
GCGAAGGGCCA: CGAAGGGCCAG
CGAAGGGCCAG: GAAGGGCCAGT
GAAGGGCCAGT: AAGGGCCAGTC
AAGGGCCAGTC: AGGGCCAGTCG
AGGGCCAGTCG: GGGCCAGTCGA
GGGCCAGTCGA: GGCCAGTCGAG
GGCCAGTCGAG: GCCAGTCGAGC
GCCAGTCGAGC: CCAGTCGAGCG
CCAGTCGAGCG: CAGTCGAGCGT
CAGTCGAGCGT: AGTCGAGCGTT
AGTCGAGCGTT: GTCGAGCGTTA
GTCGAGCGTTA: TCGAGCGTTAT
TCGAGCGTTAT: CGAGCGTTATG
CGAGCGTTATG: GAGCGTTATGA
GAGCGTTATGA: AGCGTTATGAC
AGCGTTATGAC: GCGTTATGACC
GCGTTATGACC: CGTTATGACCG
CGTTATGACCG: GTTATGACCGT
GTTATGACCGT: TTATGACCGTG
TTATGACCGTG: TATGACCGTGA
TATGACCGTGA: ATGACCGTGAC
ATGACCGTGAC: TGACCGTGACT
TGACCGTGACT: GACCGTGACTA
GACCGTGACTA: ACCGTGACTAT
ACCGTGACTAT: CCGTGACTATA
CCGTGACTATA: CGTGACTATAA
CGTGACTATAA: GTGACTATAAC
GTGACTATAAC: TGACTATAACG
TGACTATAACG: GACTATAACGG
GACTATAACGG: ACTATAACGGA
ACTATAACGGA: CTATAACGGAC
CTATAACGGAC: TATAACGGACT
TATAACGGACT: ATAACGGACTA
ATAACGGACTA: TAACGGACTAT
TAACGGACTAT: AACGGACTATC
AACGGACTATC: ACGGACTATCA
ACGGACTATCA: CGGACTATCAG
CGGACTATCAG: GGACTATCAGC
GGACTATCAGC: GACTATCAGCG
GACTATCAGCG: ACTATCAGCGA
ACTATCAGCGA: CTATCAGCGAC
CTATCAGCGAC: TATCAGCGACT
TATCAGCGACT: ATCAGCGACTG
ATCAGCGACTG: TCAGCGACTGA
TCAGCGACTGA: CAGCGACTGAA
CAGCGACTGAA: AGCGACTGAAA
AGCGACTGAAA: GCGACTGAAAT
GCGACTGAAAT: CGACTGAAATA
CGACTGAAATA: GACTGAAATAG
GACTGAAATAG: ACTGAAATAGC
ACTGAAATAGC: CTGAAATAGCT
CTGAAATAGCT: TGAAATAGCTA
TGAAATAGCTA: GAAATAGCTAG
GAAATAGCTAG: AAATAGCTAGA
AAATAGCTAGA: AATAGCTAGAT
AATAGCTAGAT: ATAGCTAGATC
ATAGCTAGATC: TAGCTAGATCT
TAGCTAGATCT: AGCTAGATCTT
AGCTAGATCTT: GCTAGATCTTA
GCTAGATCTTA: CTAGATCTTAA
CTAGATCTTAA: TAGATCTTAAC
TAGATCTTAAC: AGATCTTAACT
AGATCTTAACT: GATCTTAACTC
GATCTTAACTC: ATCTTAACTCC
ATCTTAACTCC: TCTTAACTCCC
TCTTAACTCCC: CTTAACTCCCC
CTTAACTCCCC: TTAACTCCCCT
TTAACTCCCCT: TAACTCCCCTG
TAACTCCCCTG: AACTCCCCTGA
AACTCCCCTGA: ACTCCCCTGAC
ACTCCCCTGAC: CTCCCCTGACC
CTCCCCTGACC: TCCCCTGACCT
TCCCCTGACCT: CCCCTGACCTA
CCCCTGACCTA: CCCTGACCTAC
CCCTGACCTAC: CCTGACCTACG
CCTGACCTACG: CTGACCTACGT
CTGACCTACGT: TGACCTACGTT
TGACCTACGTT: GACCTACGTTT
GACCTACGTTT: ACCTACGTTTT
ACCTACGTTTT: CCTACGTTTTA
CCTACGTTTTA: CTACGTTTTAG
CTACGTTTTAG: TACGTTTTAGA
TACGTTTTAGA: ACGTTTTAGAG
ACGTTTTAGAG: CGTTTTAGAGC
CGTTTTAGAGC: GTTTTAGAGCA
GTTTTAGAGCA: TTTTAGAGCAG
TTTTAGAGCAG: TTTAGAGCAGA
TTTAGAGCAGA: TTAGAGCAGAT
TTAGAGCAGAT: TAGAGCAGATT
TAGAGCAGATT: AGAGCAGATTG
AGAGCAGATTG: GAGCAGATTGC
GAGCAGATTGC: AGCAGATTGCA
AGCAGATTGCA: GCAGATTGCAT
GCAGATTGCAT: CAGATTGCATC
CAGATTGCATC: AGATTGCATCG
AGATTGCATCG: GATTGCATCGG
GATTGCATCGG: ATTGCATCGGA
ATTGCATCGGA: TTGCATCGGAT
TTGCATCGGAT: TGCATCGGATG
TGCATCGGATG: GCATCGGATGA
GCATCGGATGA: CATCGGATGAT
CATCGGATGAT: ATCGGATGATT
ATCGGATGATT: TCGGATGATTT
TCGGATGATTT: CGGATGATTTA
CGGATGATTTA: GGATGATTTAT
GGATGATTTAT: GATGATTTATA
GATGATTTATA: ATGATTTATAG
ATGATTTATAG: TGATTTATAGA
TGATTTATAGA: GATTTATAGAT
GATTTATAGAT: ATTTATAGATA
ATTTATAGATA: TTTATAGATAG
TTTATAGATAG: TTATAGATAGG
TTATAGATAGG: TATAGATAGGG
TATAGATAGGG: ATAGATAGGGC
ATAGATAGGGC: TAGATAGGGCG
TAGATAGGGCG: AGATAGGGCGC
AGATAGGGCGC: GATAGGGCGCT
GATAGGGCGCT: ATAGGGCGCTA
ATAGGGCGCTA: TAGGGCGCTAG
TAGGGCGCTAG: AGGGCGCTAGT
AGGGCGCTAGT: GGGCGCTAGTA
GGGCGCTAGTA: GGCGCTAGTAC
GGCGCTAGTAC: GCGCTAGTACT
GCGCTAGTACT: CGCTAGTACTC
CGCTAGTACTC: GCTAGTACTCA
GCTAGTACTCA: CTAGTACTCAC
CTAGTACTCAC: TAGTACTCACT
TAGTACTCACT: AGTACTCACTT
AGTACTCACTT: GTACTCACTTC
GTACTCACTTC: TACTCACTTCG
TACTCACTTCG: ACTCACTTCGG
ACTCACTTCGG: CTCACTTCGGA
CTCACTTCGGA: TCACTTCGGAT
TCACTTCGGAT: CACTTCGGATG
CACTTCGGATG: ACTTCGGATGA
ACTTCGGATGA: CTTCGGATGAG
CTTCGGATGAG: TTCGGATGAGG
TTCGGATGAGG: TCGGATGAGGC
TCGGATGAGGC: CGGATGAGGCC
CGGATGAGGCC: GGATGAGGCCG
GGATGAGGCCG: GATGAGGCCGT
GATGAGGCCGT: ATGAGGCCGTC
ATGAGGCCGTC: TGAGGCCGTCG
TGAGGCCGTCG: GAGGCCGTCGG
GAGGCCGTCGG: AGGCCGTCGGA
AGGCCGTCGGA: GGCCGTCGGAA
GGCCGTCGGAA: GCCGTCGGAAA
GCCGTCGGAAA: CCGTCGGAAAG
CCGTCGGAAAG: CGTCGGAAAGG
CGTCGGAAAGG: GTCGGAAAGGC
GTCGGAAAGGC: TCGGAAAGGCT
TCGGAAAGGCT: CGGAAAGGCTC
CGGAAAGGCTC: GGAAAGGCTCT
GGAAAGGCTCT: GAAAGGCTCTC
GAAAGGCTCTC: AAAGGCTCTCT
AAAGGCTCTCT: AAGGCTCTCTT
AAGGCTCTCTT: AGGCTCTCTTG
AGGCTCTCTTG: GGCTCTCTTGT
GGCTCTCTTGT: GCTCTCTTGTT
GCTCTCTTGTT: CTCTCTTGTTC
CTCTCTTGTTC: TCTCTTGTTCA
TCTCTTGTTCA: CTCTTGTTCAA
CTCTTGTTCAA: TCTTGTTCAAT
TCTTGTTCAAT: CTTGTTCAATA
CTTGTTCAATA: TTGTTCAATAG
TTGTTCAATAG: TGTTCAATAGT
TGTTCAATAGT: GTTCAATAGTG
GTTCAATAGTG: TTCAATAGTGT
TTCAATAGTGT: TCAATAGTGTA
TCAATAGTGTA: CAATAGTGTAC
CAATAGTGTAC: AATAGTGTACG
AATAGTGTACG: ATAGTGTACGG
ATAGTGTACGG: TAGTGTACGGG
TAGTGTACGGG: AGTGTACGGGA
AGTGTACGGGA: GTGTACGGGAA
GTGTACGGGAA: TGTACGGGAAT
TGTACGGGAAT: GTACGGGAATC
GTACGGGAATC: TACGGGAATCC
TACGGGAATCC: ACGGGAATCCG
ACGGGAATCCG: CGGGAATCCGC
CGGGAATCCGC: GGGAATCCGCT
GGGAATCCGCT: GGAATCCGCTC
GGAATCCGCTC: GAATCCGCTCA
GAATCCGCTCA: AATCCGCTCAT
AATCCGCTCAT: ATCCGCTCATG
ATCCGCTCATG: TCCGCTCATGT
TCCGCTCATGT: CCGCTCATGTT
CCGCTCATGTT: CGCTCATGTTC
CGCTCATGTTC: GCTCATGTTCA
GCTCATGTTCA: CTCATGTTCAC
CTCATGTTCAC: TCATGTTCACG
TCATGTTCACG: CATGTTCACGT
CATGTTCACGT: ATGTTCACGTG
ATGTTCACGTG: TGTTCACGTGC
TGTTCACGTGC: GTTCACGTGCT
GTTCACGTGCT: TTCACGTGCTG
TTCACGTGCTG: TCACGTGCTGC
TCACGTGCTGC: CACGTGCTGCA
CACGTGCTGCA: ACGTGCTGCAG
ACGTGCTGCAG: CGTGCTGCAGG
CGTGCTGCAGG: GTGCTGCAGGC
GTGCTGCAGGC: TGCTGCAGGCA
TGCTGCAGGCA: GCTGCAGGCAT
GCTGCAGGCAT: CTGCAGGCATT
CTGCAGGCATT: TGCAGGCATTT
TGCAGGCATTT: GCAGGCATTTA
GCAGGCATTTA: CAGGCATTTAT
CAGGCATTTAT: AGGCATTTATG
AGGCATTTATG: GGCATTTATGC
GGCATTTATGC: GCATTTATGCA
GCATTTATGCA: CATTTATGCAC
CATTTATGCAC: ATTTATGCACG
ATTTATGCACG: TTTATGCACGC
TTTATGCACGC: TTATGCACGCT
TTATGCACGCT: TATGCACGCTC
TATGCACGCTC: ATGCACGCTCG
ATGCACGCTCG: TGCACGCTCGC
TGCACGCTCGC: GCACGCTCGCG
GCACGCTCGCG: CACGCTCGCGG
CACGCTCGCGG: ACGCTCGCGGT
ACGCTCGCGGT: CGCTCGCGGTT
CGCTCGCGGTT: GCTCGCGGTTG
GCTCGCGGTTG: CTCGCGGTTGC
CTCGCGGTTGC: TCGCGGTTGCG
TCGCGGTTGCG: CGCGGTTGCGA
CGCGGTTGCGA: GCGGTTGCGAC
GCGGTTGCGAC: CGGTTGCGACG
CGGTTGCGACG: GGTTGCGACGG
GGTTGCGACGG: GTTGCGACGGG
GTTGCGACGGG: TTGCGACGGGG
TTGCGACGGGG: TGCGACGGGGG
TGCGACGGGGG: GCGACGGGGGA
GCGACGGGGGA: CGACGGGGGAG
CGACGGGGGAG: GACGGGGGAGG
GACGGGGGAGG: ACGGGGGAGGA
ACGGGGGAGGA: CGGGGGAGGAC
CGGGGGAGGAC: GGGGGAGGACC
GGGGGAGGACC: GGGGAGGACCG
GGGGAGGACCG: GGGAGGACCGT
GGGAGGACCGT: GGAGGACCGTC
GGAGGACCGTC: GAGGACCGTCA
GAGGACCGTCA: AGGACCGTCAG
AGGACCGTCAG: GGACCGTCAGC
GGACCGTCAGC: GACCGTCAGCA
GACCGTCAGCA: ACCGTCAGCAT
ACCGTCAGCAT: CCGTCAGCATG
CCGTCAGCATG: CGTCAGCATGG
CGTCAGCATGG: GTCAGCATGGT
GTCAGCATGGT: TCAGCATGGTA
TCAGCATGGTA: CAGCATGGTAA
CAGCATGGTAA: AGCATGGTAAC
AGCATGGTAAC: GCATGGTAACT
GCATGGTAACT: CATGGTAACTT
CATGGTAACTT: ATGGTAACTTA
ATGGTAACTTA: TGGTAACTTAA
TGGTAACTTAA: GGTAACTTAAC
GGTAACTTAAC: GTAACTTAACG
GTAACTTAACG: TAACTTAACGG
TAACTTAACGG: AACTTAACGGC
AACTTAACGGC: ACTTAACGGCG
ACTTAACGGCG: CTTAACGGCGC
CTTAACGGCGC: TTAACGGCGCG
TTAACGGCGCG: TAACGGCGCGA
TAACGGCGCGA: AACGGCGCGAG
AACGGCGCGAG: ACGGCGCGAGT
ACGGCGCGAGT: CGGCGCGAGTG
CGGCGCGAGTG: GGCGCGAGTGT
GGCGCGAGTGT: GCGCGAGTGTG
GCGCGAGTGTG: CGCGAGTGTGG
CGCGAGTGTGG: GCGAGTGTGGC
GCGAGTGTGGC: CGAGTGTGGCC
CGAGTGTGGCC: GAGTGTGGCCT
GAGTGTGGCCT: AGTGTGGCCTC
AGTGTGGCCTC: GTGTGGCCTCT
GTGTGGCCTCT: TGTGGCCTCTT
TGTGGCCTCTT: GTGGCCTCTTG
GTGGCCTCTTG: TGGCCTCTTGG
TGGCCTCTTGG: GGCCTCTTGGC
GGCCTCTTGGC: GCCTCTTGGCA
GCCTCTTGGCA: CCTCTTGGCAC
CCTCTTGGCAC: CTCTTGGCACC
CTCTTGGCACC: TCTTGGCACCA
TCTTGGCACCA: CTTGGCACCAC
CTTGGCACCAC: TTGGCACCACT
TTGGCACCACT: TGGCACCACTG
TGGCACCACTG: GGCACCACTGT
GGCACCACTGT: GCACCACTGTC
GCACCACTGTC: CACCACTGTCC
CACCACTGTCC: ACCACTGTCCC
ACCACTGTCCC: CCACTGTCCCG
CCACTGTCCCG: CACTGTCCCGA
CACTGTCCCGA: ACTGTCCCGAG
ACTGTCCCGAG: CTGTCCCGAGA
CTGTCCCGAGA: TGTCCCGAGAT
TGTCCCGAGAT: GTCCCGAGATG
GTCCCGAGATG: TCCCGAGATGG
TCCCGAGATGG: CCCGAGATGGG
CCCGAGATGGG: CCGAGATGGGG
CCGAGATGGGG: CGAGATGGGGG
CGAGATGGGGG: GAGATGGGGGG
GAGATGGGGGG: AGATGGGGGGC
AGATGGGGGGC: GATGGGGGGCT
GATGGGGGGCT: ATGGGGGGCTA
ATGGGGGGCTA: TGGGGGGCTAA
TGGGGGGCTAA: GGGGGGCTAAT
GGGGGGCTAAT: GGGGGCTAATT
GGGGGCTAATT: GGGGCTAATTG
GGGGCTAATTG: GGGCTAATTGA
GGGCTAATTGA: GGCTAATTGAG
GGCTAATTGAG: GCTAATTGAGG
GCTAATTGAGG: CTAATTGAGGT
CTAATTGAGGT: TAATTGAGGTC
TAATTGAGGTC: AATTGAGGTCA
AATTGAGGTCA: ATTGAGGTCAA
ATTGAGGTCAA: TTGAGGTCAAT
TTGAGGTCAAT: TGAGGTCAATG
TGAGGTCAATG: GAGGTCAATGC
GAGGTCAATGC: AGGTCAATGCC
AGGTCAATGCC: GGTCAATGCCC
GGTCAATGCCC: GTCAATGCCCC
GTCAATGCCCC: TCAATGCCCCG
TCAATGCCCCG: CAATGCCCCGG
CAATGCCCCGG: AATGCCCCGGC
AATGCCCCGGC: ATGCCCCGGCC
ATGCCCCGGCC: TGCCCCGGCCC
TGCCCCGGCCC: GCCCCGGCCCT
GCCCCGGCCCT: CCCCGGCCCTA
CCCCGGCCCTA: CCCGGCCCTAC
CCCGGCCCTAC: CCGGCCCTACC
CCGGCCCTACC: CGGCCCTACCG
CGGCCCTACCG: GGCCCTACCGT
GGCCCTACCGT: GCCCTACCGTA
GCCCTACCGTA: CCCTACCGTAT
CCCTACCGTAT: CCTACCGTATT
CCTACCGTATT: CTACCGTATTC
CTACCGTATTC: TACCGTATTCA
TACCGTATTCA: ACCGTATTCAC
ACCGTATTCAC: CCGTATTCACG
CCGTATTCACG: CGTATTCACGC
CGTATTCACGC: GTATTCACGCA
GTATTCACGCA: TATTCACGCAA
TATTCACGCAA: ATTCACGCAAG
ATTCACGCAAG: TTCACGCAAGA
TTCACGCAAGA: TCACGCAAGAC
TCACGCAAGAC: CACGCAAGACT
CACGCAAGACT: ACGCAAGACTG
ACGCAAGACTG: CGCAAGACTGT
CGCAAGACTGT: GCAAGACTGTG
GCAAGACTGTG: CAAGACTGTGT
CAAGACTGTGT: AAGACTGTGTA
AAGACTGTGTA: AGACTGTGTAT
AGACTGTGTAT: GACTGTGTATG
GACTGTGTATG: ACTGTGTATGT
ACTGTGTATGT: CTGTGTATGTT
CTGTGTATGTT: TGTGTATGTTT
TGTGTATGTTT: GTGTATGTTTA
GTGTATGTTTA: TGTATGTTTAC
TGTATGTTTAC: GTATGTTTACA
GTATGTTTACA: TATGTTTACAC
TATGTTTACAC: ATGTTTACACA
ATGTTTACACA: TGTTTACACAC
TGTTTACACAC: GTTTACACACA
GTTTACACACA: TTTACACACAA
TTTACACACAA: TTACACACAAA
TTACACACAAA: TACACACAAAC
TACACACAAAC: ACACACAAACG
ACACACAAACG: CACACAAACGC
CACACAAACGC: ACACAAACGCT
ACACAAACGCT: CACAAACGCTT
CACAAACGCTT: ACAAACGCTTA
ACAAACGCTTA: CAAACGCTTAC
CAAACGCTTAC: AAACGCTTACA
AAACGCTTACA: AACGCTTACAG
AACGCTTACAG: ACGCTTACAGT
ACGCTTACAGT: CGCTTACAGTG
CGCTTACAGTG: GCTTACAGTGA
GCTTACAGTGA: CTTACAGTGAG
CTTACAGTGAG: TTACAGTGAGT
TTACAGTGAGT: TACAGTGAGTG
TACAGTGAGTG: ACAGTGAGTGT
ACAGTGAGTGT: CAGTGAGTGTA
CAGTGAGTGTA: AGTGAGTGTAA
AGTGAGTGTAA: GTGAGTGTAAA
GTGAGTGTAAA: TGAGTGTAAAG
TGAGTGTAAAG: GAGTGTAAAGG
GAGTGTAAAGG: AGTGTAAAGGA
AGTGTAAAGGA: GTGTAAAGGAG
GTGTAAAGGAG: TGTAAAGGAGC
TGTAAAGGAGC: GTAAAGGAGCG
GTAAAGGAGCG: TAAAGGAGCGT
TAAAGGAGCGT: AAAGGAGCGTC
AAAGGAGCGTC: AAGGAGCGTCC
AAGGAGCGTCC: AGGAGCGTCCA
AGGAGCGTCCA: GGAGCGTCCAG
GGAGCGTCCAG: GAGCGTCCAGC
GAGCGTCCAGC: AGCGTCCAGCC
AGCGTCCAGCC: GCGTCCAGCCC
GCGTCCAGCCC: CGTCCAGCCCC
CGTCCAGCCCC: GTCCAGCCCCT
GTCCAGCCCCT: TCCAGCCCCTA
TCCAGCCCCTA: CCAGCCCCTAG
CCAGCCCCTAG: CAGCCCCTAGA
CAGCCCCTAGA: AGCCCCTAGAT
AGCCCCTAGAT: GCCCCTAGATA
GCCCCTAGATA: CCCCTAGATAG
CCCCTAGATAG: CCCTAGATAGC
CCCTAGATAGC: CCTAGATAGCG
CCTAGATAGCG: CTAGATAGCGT
CTAGATAGCGT: TAGATAGCGTG
TAGATAGCGTG: AGATAGCGTGC
AGATAGCGTGC: GATAGCGTGCG
GATAGCGTGCG: ATAGCGTGCGA
ATAGCGTGCGA: TAGCGTGCGAT
TAGCGTGCGAT: AGCGTGCGATA
AGCGTGCGATA: GCGTGCGATAG
GCGTGCGATAG: CGTGCGATAGG
CGTGCGATAGG: GTGCGATAGGC
GTGCGATAGGC: TGCGATAGGCT
TGCGATAGGCT: GCGATAGGCTG
GCGATAGGCTG: CGATAGGCTGG
CGATAGGCTGG: GATAGGCTGGG
